&	ㅀ
&/8&/l&n	ㅀㄷ㍕
&/8&/li/y&t	ㅀㄷも㉦
&/8&b	ㅀ㐕
&/8&b/t&/rE	ㅀ㐕ㄒ〕
&/8&b/t&r	ㅀ㐕〄
&/8&l	ㅀ㞑
&/G&/bE	ㅀ㆗】
&/G&/lE	ㅀ㆗ぅ
&/G&b	ㅀ㤰
&/Ga/yE/bE	ㅀ〉〤】
&/Ga/yEb	ㅀ〉䌂
&/Gi/bE	ㅀ㌆】
&/Gi/bi	ㅀ㌆ち
&/Gi/bi/E	ㅀ㌆ち【
&/Gi/bi/yE	ㅀ㌆ち〤
&/Gi/mol/Gos/tE	ㅀ㌆䖆䉆つ
&/Gib	ㅀ䉄
&/b&d	ㅀ㄂
&/b&l/f&z	ㅀ㝣㝤
&/ba/si	ㅀ〱々
&/d&/bi	ㅀ㄰ち
&/d&/da/ro	ㅀ㄰〴〹
&/d&b	ㅀ䑤
&/da	ㅀ〴
&/da/yE	ㅀ〴〤
&/daS	ㅀ㈂
&/di/a/nE	ㅀび〧〆
&/g&r	ㅀ㈥
&/gE	ㅀぴ
&/h&n	ㅀ㐈
&/i	ㅀ〷
&/ka/so	ㅀ㐶ㅇ
&/l&/f&m	ㅀ㌧㙓
&/l&/fE	ㅀ㌧㈷
&/l&/ki	ㅀ㌧〥
&/l&/ki/E	ㅀ㌧〥【
&/l&f	ㅀ䠦
&/l&n	ㅀ㍕
&/l&n/gu/a/to	ㅀ㍕〒〧〙
&/lEf/ba	ㅀ䐔〱
&/la/8E/haS	ㅀ〢㊁㉰
&/la/8E/m&nd	ㅀ〢㊁䞐
&/la/8E/yE	ㅀ〢㊁〤
&/la/m&/tES	ㅀ〢ば㉩
&/la/m&t	ㅀ〢㝡
&/la/niS	ㅀ〢㊇
&/la/vE	ㅀ〢㔈
&/lah	ㅀ䍤
&/lan	ㅀ㍒
&/le/hE	ㅀ㑢ご
&/le/ki	ㅀ㑢〥
&/li	ㅀも
&/li/ba/ba	ㅀも〱〱
&/li/rE/za	ㅀも〕㎇
&/li/rE/za/han	ㅀも〕㎇ㅉ
&/li/sa	ㅀも㈆
&/li/yE	ㅀも〤
&/li/ya	ㅀもㄈ
&/lo	ㅀ㌳
&/lo/ko/l&N	ㅀ㌳ぇ㕅
&/m&/l&n	ㅀば㍕
&/m&/li	ㅀばも
&/m&l	ㅀ䌇
&/mE	ㅀㆂ
&/mE/haS	ㅀㆂ㉰
&/ma	ㅀ〖
&/ma/n&t	ㅀ〖㒁
&/ma/na	ㅀ〖〸
&/min	ㅀ㉴
&/mir	ㅀ㑈
&/mir/&/li	ㅀ㑈ㅀも
&/mir/ho/sen	ㅀ㑈㌱䍧
&/mir/pa/Sa	ㅀ㑈〘〨
&/mir/pu/ya	ㅀ㑈ゆㄈ
&/mu	ㅀ㉀
&/mu/Si	ㅀ㉀げ
&/mu/di/ha	ㅀ㉀びと
&/mu/ha	ㅀ㉀と
&/mu/no/ruz	ㅀ㉀ㆈ㈐
&/muS	ㅀ㑗
&/na/rE/mun	ㅀ〸〕だ
&/na/ro	ㅀ〸〹
&/nar	ㅀ㥷
&/ni/ma/si/o/nE	ㅀこ〖々㈔〆
&/r&/bi	ㅀ㈀ち
&/r&8	ㅀ㐠
&/ru/s&/k&/ro	ㅀㄹづㅖ〹
&/ru/s&/k&m	ㅀㄹづ㉘
&/ru/s&/kE	ㅀㄹづㄢ
&/ru/s&/kE/ta/rE	ㅀㄹづㄢゅ〕
&/ru/s&/kES	ㅀㄹづ㌐
&/ru/s&/kEt	ㅀㄹづ㊑
&/ru/s&/ka	ㅀㄹづ㐶
&/ru/s&/ka/ro	ㅀㄹづ㐶〹
&/ru/s&/ka/yE	ㅀㄹづ㐶〤
&/ru/s&/kaS	ㅀㄹづ㌘
&/ru/s&/kat	ㅀㄹづ䈅
&/ru/s&/ki	ㅀㄹづ〥
&/ru/s&/ki/&n	ㅀㄹづ〥ㅐ
&/ru/s&/ko	ㅀㄹづぇ
&/ru/s&k	ㅀㄹ㐒
&/ru/s&k/g&r/du/na	ㅀㄹ㐒㈥ㄩ〸
&/ru/s&k/g&r/dun	ㅀㄹ㐒㈥㙣
&/ru/sE	ㅀㄹ〇
&/ru/si	ㅀㄹ々
&/ru/si/E	ㅀㄹ々【
&/rus	ㅀ㖁
&/s&/ba/ni	ㅀづ〱こ
&/s&/ba/ni/&t	ㅀづ〱こ㉤
&/s&/ba/ni/E	ㅀづ〱こ【
&/s&/ba/ni/m&m	ㅀづ〱こ㍲
&/s&/ba/ni/y&m	ㅀづ〱こ㥹
&/s&/ba/ni/y&t	ㅀづ〱こ㉦
&/s&/ba/niS	ㅀづ〱㊇
&/s&/ba/nim	ㅀづ〱ㄶ
&/s&/bi	ㅀづち
&/s&/di	ㅀづび
&/s&/l&m	ㅀづㆄ
&/s&/lE	ㅀづぅ
&/s&/li	ㅀづも
&/s&/nE	ㅀづ〆
&/s&/rE	ㅀづ〕
&/s&/rE/S&m	ㅀづ〕㆑
&/s&/rES	ㅀづて
&/s&l	ㅀ䅇
&/s&n	ㅀ㐙
&/s&n/mi/gE	ㅀ㐙〃ぴ
&/s&n/xob	ㅀ㐙〶
&/s&r	ㅀ㎙
&/sa	ㅀ㈆
&/sa/b&m	ㅀ㈆㙢
&/sa/bE	ㅀ㈆】
&/sa/bES	ㅀ㈆㌕
&/sa/ro	ㅀ㈆〹
&/sa/sE	ㅀ㈆〇
&/sa/yE	ㅀ㈆〤
&/sib	ㅀ䁷
&/sir	ㅀ㘒
&/t&l	ㅀ㘣
&/v&/l&n	ㅀ㈶㍕
&/v&/lE	ㅀ㈶ぅ
&/v&/lE/San	ㅀ㈶ぅ㞙
&/v&/lE/Si	ㅀ㈶ぅげ
&/v&/lES	ㅀ㈶㈱
&/v&/laS	ㅀ㈶㜗
&/v&/li	ㅀ㈶も
&/v&/li/E/yE	ㅀ㈶も【〤
&/v&/liS	ㅀ㈶䀘
&/v&/lin	ㅀ㈶ㄤ
&/v&/zE	ㅀ㈶ㄕ
&/v&/zES	ㅀ㈶ㄧ
&/v&/zEt	ㅀ㈶㚄
&/v&/zi	ㅀ㈶ㄵ
&/v&l	ㅀㅁ
&/v&l/cE/ra	ㅀㅁでㅹ
&/v&z	ㅀ㜈
&/v&z/E	ㅀ㜈【
&/v&z/dar	ㅀ㜈㐑
&/va/rE/zE	ㅀゃ〕ㄕ
&/x&/rES	ㅀ㆖て
&/xir	ㅀ䞁
&/z&/Sun	ㅀㄥ㆒
&/z&/mun	ㅀㄥだ
&/z&/tun	ㅀㄥㄖ
&/z&S	ㅀㅓ
&/z&m	ㅀ㑶
&/z&t	ㅀ㡵
&/z&z	ㅀ䆁
&/zES	ㅀㄧ
&/za/b&m	ㅀ㎇㙢
&/zi/&/tE/Sun	ㅀㄵㅀつ㆒
&/zi/&/tEt	ㅀㄵㅀ㕶
&/zi/&t	ㅀㄵ㉤
&/zi/mol/Gos/tE	ㅀㄵ䖆䉆つ
&/zi/y&/tES	ㅀㄵ㍗㉩
&/zi/y&/tEt	ㅀㄵ㍗㕶
&/zi/y&t	ㅀㄵ㉦
&/zi/z&/k&m	ㅀㄵㄥ㉘
&/zi/z&k	ㅀㄵ㕤
&/zi/z&m	ㅀㄵ㑶
&/zi/zE	ㅀㄵㄕ
&/zi/zEt	ㅀㄵ㚄
&/zi/za	ㅀㄵ㎇
&/zi/zi	ㅀㄵㄵ
&/zin	ㅀ䖐
&/ziz	ㅀ䀆
&/zo/lat	ㅀ㝉㑹
&8&l	㠙
&8/l&/mo	䑗㌧㈓
&8/l&b	䑗䘈
&8/lEt	䑗㆔
&G&b	䜡
&Niz	䈤
&NizE	䙒
&NiziyE	㜧
&b/do	㢈〰
&b/do/li	㢈〰も
&b/rES/mi/SE	㢈て〃ㅠ
&b/ru	㢈ㄹ
&b/ru/SE	㢈ㄹㅠ
&b/rut	㢈㢉
&b/zar	㢈〠
&br	䖂
&bra	䖄
&d/vE/yE/Ga/tE	䡕㔈〤〉つ
&f/Sar	䁃㜐
&f/ra/dE	䁃ㅹあ
&f/ra/dE/So	䁃ㅹあ〈
&f/rad	䁃㚇
&f/rin	䁃ㅃ
&f/sa/nE	䁃㈆〆
&f/sa/nE/ha	䁃㈆〆と
&f/sa/nE/ha/yi	䁃㈆〆と㆕
&gE	䎑
&h	㙇
&h/li	㙇も
&h/m&/di/nE/Ga/dE	㙇ばび〆〉あ
&h/val	㙇䍦
&h/val/por/si	㙇䍦㉕々
&k/b&/ri	ㄆ〡〵
&k/b&r	ㄆ㈤
&k/s&/rE	ㄆづ〕
&k/s&/rE/SE	ㄆづ〕ㅠ
&k/s&/rES	ㄆづて
&k/s&/ra/yE	ㄆづㅹ〤
&k/s&/ri	ㄆづ〵
&k/s&/ri/SE	ㄆづ〵ㅠ
&k/s&/ri/So	ㄆづ〵〈
&k/s&/ri/ya/ro	ㄆづ〵ㄈ〹
&k/s&/riS	ㄆづ㐢
&k/s&/rin	ㄆづㅃ
&k/s&/rit	ㄆづ㡱
&k/s&r	ㄆ㎙
&k/s&r/sar	ㄆ㎙㘆
&k/sE	ㄆ〇
&k/sE/S&m	ㄆ〇㆑
&k/sE/to	ㄆ〇〙
&k/sES	ㄆ㐃
&k/sEt	ㄆㅸ
&k/sEy	ㄆㄇ
&k/sa	ㄆ㈆
&ks	ㄓ
&ks/e	ㄓゑ
&l/b&/tE	㠆〡つ
&l/h&m/du/la	㠆〦ㄩ〢
&l/mas	㠆䄴
&lekum	䄓
&m/8E/zi	〓㊁ㄵ
&m/kul	〓䑱
&ma	䢇
&mn	䔨
&n	ㅐ
&n/Gam	ㅐ䀈
&n/Gir	ㅐ㎉
&n/bE	ㅐ】
&n/bE/yi	ㅐ】㆕
&n/bEyE	ㅐ䜀
&n/ba/ri	ㅐ〱〵
&n/dE/zE	ㅐあㄕ
&n/dE/zE/yE	ㅐあㄕ〤
&n/da/zE/yE	ㅐ〴ㄕ〤
&n/da/zE/yi	ㅐ〴ㄕ㆕
&n/dax/t&m	ㅐㅧㅨ
&n/dax/tE	ㅐㅧつ
&n/dax/ti	ㅐㅧㅔ
&n/daxt	ㅐ㙅
&n/goS/t&/r&m	ㅐ㍹ㄒ㄄
&n/goS/t&/rE	ㅐ㍹ㄒ〕
&n/goS/t&t	ㅐ㍹䘩
&n/goS/tE/So	ㅐ㍹つ〈
&n/goS/tES	ㅐ㍹㉩
&n/goS/tEt	ㅐ㍹㕶
&n/goS/ta/SE	ㅐ㍹ゅㅠ
&n/goS/ta/Sun	ㅐ㍹ゅ㆒
&n/goS/ta/yE	ㅐ㍹ゅ〤
&n/goS/taS	ㅐ㍹㐵
&n/goS/tat	ㅐ㍹㤱
&n/goSt	ㅐ㌴
&n/gu/r&m	ㅐ〒㄄
&n/gu/rE	ㅐ〒〕
&n/gur	ㅐ䜒
&n/k&/bud	ㅐㅖ㉄
&nkum	䒑
&nt	䅘
&r/ba/bE	㡐〱】
&r/zu/nE	㡐㖅〆
&r/zun	㡐㙂
&r/zun/t&/ri/nE/SE	㡐㙂ㄒ〵〆ㅠ
&rz	䔇
&s	㆘
&s&n	䜢
&s/8&r	㆘㑅
&s/b&/b&/zi/yE	㆘〡〡ㄵ〤
&s/b&/r&m	㆘〡㄄
&s/b&m	㆘㙢
&s/b&st	㆘㙖
&s/bE	㆘】
&s/bES	㆘㌕
&s/bEt	㆘㐥
&s/ba	㆘〱
&s/ba/b&/zi/ha	㆘〱〡ㄵと
&s/ba/ba/i/a	㆘〱〱〷〧
&s/ba/ba/yE	㆘〱〱〤
&s/ba/ba/zi	㆘〱〱ㄵ
&s/ba/ba/zi/&/yE	㆘〱〱ㄵㅀ〤
&s/ba/ba/zi/&t	㆘〱〱ㄵ㉤
&s/ba/ba/zi/a/i	㆘〱〱ㄵ〧〷
&s/ba/ba/zi/aS	㆘〱〱ㄵ㒈
&s/ba/ba/zi/at	㆘〱〱ㄵ㥔
&s/ba/ba/zi/ha	㆘〱〱ㄵと
&s/ba/ba/zi/ha/ro	㆘〱〱ㄵと〹
&s/ba/ba/zi/ha/yE	㆘〱〱ㄵと〤
&s/ba/ba/zi/ha/yi	㆘〱〱ㄵと㆕
&s/ba/ba/zi/hat	㆘〱〱ㄵ㕂
&s/ba/ba/zi/to	㆘〱〱ㄵ〙
&s/ba/ba/zi/yE	㆘〱〱ㄵ〤
&s/ba/ba/zi/yi	㆘〱〱ㄵ㆕
&s/ba/yE	㆘〱〤
&s/bab	㆘㤥
&s/bi	㆘ち
&s/l&/hE	㆘㌧ご
&s/l&/hE/ha	㆘㌧ごと
&s/l&/hE/i	㆘㌧ご〷
&s/l&n	㆘㍕
&s/lE	㆘ぅ
&s/lan	㆘㍒
&s/li	㆘も
&s/ra/ra/mi/zE	㆘ㅹㅹ〃ㄕ
&s/ra/ra/mi/zi	㆘ㅹㅹ〃ㄵ
&s/ri	㆘〵
&s/ri/yE	㆘〵〤
&s/ru/n&/mun	㆘ㄹゔだ
&s/ru/n&/ro	㆘ㄹゔ〹
&s/ru/n&t	㆘ㄹ㒁
&s/ru/nE	㆘ㄹ〆
&sb	㤤
&sb/s&/va/ri	㤤づゃ〵
&sl	䡇
&sr	㙧
&t/rE	㉤〕
&t/ra/fE	㉤ㅹ㈷
&t/sE	㉤〇
&v&lES	䠕
&v&lin	䠖
&x/t&/r&n	䐗ㄒへ
&z	、
&z/m&n	、㄁
&z/nE/mi/du/ni	、〆〃ㄩこ
&z/pEs/tu/n&k	、䁓ㅡ㑐
&z/ta/zE	、ゅㄕ
&z/tu	、ㅡ
&z/v&/li	、㈶も
&z/xob	、〶
8&/S&N	ㄷㄸ
8&/S&n/g&/ro	ㄷむㄠ〹
8&/S&n/g&m	ㄷむ㍑
8&/S&n/gE	ㄷむぴ
8&/S&n/gES	ㄷむ㐔
8&/S&n/gEt	ㄷむ䉥
8&/S&n/gi	ㄷむん
8&/S&n/gi/E	ㄷむん【
8&/S&n/gi/yE	ㄷむん〤
8&/S&ng/t&/rE	ㄷ㐂ㄒ〕
8&/S&ng/t&/rin	ㄷ㐂ㄒㅃ
8&/S&ng/t&r	ㄷ㐂〄
8&/bu/lE	ㄷらぅ
8&/bul	ㄷ㜱
8&/d&m	ㄷㅕ
8&/d&r	ㄷㆉ
8&/dE	ㄷあ
8&/dE/Sun	ㄷあ㆒
8&/dE/tun	ㄷあㄖ
8&/dES	ㄷ㈴
8&/dEt	ㄷ㈃
8&/di/mE	ㄷびㆂ
8&/di/ma	ㄷび〖
8&/di/mi	ㄷび〃
8&/di/mi/E	ㄷび〃【
8&/di/miS	ㄷび㍂
8&/dim	ㄷ㈖
8&/l&/mo	ㄷ㌧㈓
8&/l&/mu	ㄷ㌧㉀
8&/l&/to	ㄷ㌧〙
8&/l&S	ㄷ㝓
8&/l&m	ㄷㆄ
8&/l&t	ㄷ㜥
8&/lE	ㄷぅ
8&/lE/ha	ㄷぅと
8&/lE/ham	ㄷぅ㜲
8&/lE/i	ㄷぅ〷
8&/lE/yE	ㄷぅ〤
8&/la/d&/ro	ㄷ〢㄰〹
8&/la/dE	ㄷ〢あ
8&/la/dE/yE	ㄷ〢あ〤
8&/na/ta	ㄷ〸ゅ
8&/rE/8o/rut	ㄷ〕㖀㢉
8&/rE/8u/rut	ㄷ〕㖒㢉
8&/rES	ㄷて
8&/ra/rE	ㄷㅹ〕
8&/ra/ra/yE	ㄷㅹㅹ〤
8&/rar	ㄷ㔴
8&/ri/bE	ㄷ〵】
8&/rib	ㄷ䠴
8&/tE	ㄷつ
8&/tES	ㄷ㉩
8&/ta/rE	ㄷゅ〕
8&/ta/rEt	ㄷゅ㑣
8&/tar	ㄷ䂙
8&/to/8u/tE	ㄷ〙㖒つ
8&/vE/i	ㄷ㔈〷
8&/va/r&/Sun	ㄷゃ㈀㆒
8&/vi	ㄷ㒇
8&/vi/E	ㄷ㒇【
8&/vi/a	ㄷ㒇〧
8&/vi/ha	ㄷ㒇と
8&/vi/yE	ㄷ㒇〤
8&/za	ㄷ㎇
8&/za/E	ㄷ㎇【
8&/za/SE	ㄷ㎇ㅠ
8&/za/So	ㄷ㎇〈
8&/za/Sun	ㄷ㎇㆒
8&/za/ci	ㄷ㎇ぉ
8&/za/ha	ㄷ㎇と
8&/za/ha/tun	ㄷ㎇とㄖ
8&/za/ha/yE	ㄷ㎇と〤
8&/za/ha/yi	ㄷ㎇と㆕
8&/za/mo	ㄷ㎇㈓
8&/za/ro	ㄷ㎇〹
8&/za/t&m	ㄷ㎇ㅨ
8&/za/to	ㄷ㎇〙
8&/za/tun	ㄷ㎇ㄖ
8&/za/yE	ㄷ㎇〤
8&/za/yi	ㄷ㎇㆕
8&/za/yi/yE	ㄷ㎇㆕〤
8&/zaS	ㄷっ
8&/zam	ㄷ䒔
8&/zat	ㄷ㠱
8&/zi/E	ㄷㄵ【
8&/zi/y&S	ㄷㄵ㌷
8&/zi/yE	ㄷㄵ〤
8&S	䒕
8&S/fEkr	䒕う
8&b/l&/nES	㐕㌧㉳
8&b/l&n	㐕㍕
8&b/lE	㐕ぅ
8&b/lES	㐕㈱
8&b/la/han	㐕〢ㅉ
8&b/li	㐕も
8&b/lit	㐕㕨
8&bl	㤑
8&bl/&z	㤑、
8&d	㖓
8&d/rE	㖓〕
8&d/rE/So	㖓〕〈
8&d/rES	㖓て
8&d/ri	㖓〵
8&dr	㉡
8&h/8&h/8&h	〔〔〔
8&h/rE/m&/nan	〔〕ばㅑ
8&h/rE/ma/n&m	〔〕〖〗
8&h/rE/ma/nE	〔〕〖〆
8&h/rE/ma/nan	〔〕〖ㅑ
8&h/rE/man	〔〕〩
8&h/v&st	〔䡨
8&h/vE	〔㔈
8&h/vE/i	〔㔈〷
8&h/vE/i/yE	〔㔈〷〤
8&h/vE/yE	〔㔈〤
8&h/vE/yi	〔㔈㆕
8&h/vE/yi/E	〔㔈㆕【
8&hr	䡥
8&l/b&m	㞑㙢
8&l/bES	㞑㌕
8&lb	䜧
8&lt	䌖
8&m/gi/n&n	ㅶんふ
8&m/gi/ni	ㅶんこ
8&m/gin	ㅶ㜩
8&m/ha	ㅶと
8&m/hast	ㅶ㠁
8&n/di	㚉び
8&n/di/yE	㚉び〤
8&nd	㡙
8&r	㑅
8&r/h&/man	㑅ㄱ〩
8&r8	䝲
8&rib	䡹
8&ribi	䑩
8&rz	㜒
8&s/dE	䈧あ
8&s/rE	䈧〕
8&s/rES	䈧て
8&sd	䈨
8&sr	䙦
8&t	㍴
8&t/rE	㍴〕
8&z/vin	䆑䉔
8&zayi	䙢
8E/lES	㊁㈱
8E/rE/ci	㊁〕ぉ
8E/rEc	㊁䠁
8E/ra	㊁ㅹ
8E/ri	㊁〵
8E/s&/So	㊁づ〈
8E/s&/ro	㊁づ〹
8E/s&/to	㊁づ〙
8E/s&S	㊁䆒
8E/s&t	㊁㞂
8E/sE	㊁〇
8E/sE/ha	㊁〇と
8E/sE/ha/yE	㊁〇と〤
8E/sE/hast	㊁〇㠁
8E/sE/hat	㊁〇㕂
8E/sE/yE	㊁〇〤
8E/sE/yi	㊁〇㆕
8E/tE	㊁つ
8E/za/v&t	㊁㎇䉹
8Eb/ra/8&m	䈥ㅹㅶ
8El	㔕
8El/8E/l&/k&m	㔕㊁㌧㉘
8El/8E/l&/kES	㔕㊁㌧㌐
8El/8E/l&/kEt	㔕㊁㌧㊑
8El/8E/l&k	㔕㊁㔑
8Er	㍣
8Er/mE/z&/ro	㍣ㆂㄥ〹
8Er/mE/z&n	㍣ㆂ㊖
8Er/mE/zE	㍣ㆂㄕ
8Er/mE/zES	㍣ㆂㄧ
8Er/mE/zi	㍣ㆂㄵ
8Er/mE/ziS	㍣ㆂ㕠
8Er/mEz	㍣㍤
8Ermizi	䝉
8Es/m&/tE	㝇ばつ
8Es/m&/tE/SE	㝇ばつㅠ
8Es/m&/tE/So	㝇ばつ〈
8Es/m&/tE/xo/Sa/li	㝇ばつぷ〨も
8Es/m&/tES	㝇ば㉩
8Es/m&/ti	㝇ばㅔ
8a/8a	ぃぃ
8a/E/dE	ぃ【あ
8a/Em	ぃ㈉
8a/So/8&m	ぃ〈ㅶ
8a/So/8E	ぃ〈㊁
8a/So/8E/to	ぃ〈㊁〙
8a/So/8E/tun	ぃ〈㊁ㄖ
8a/So/8Et	ぃ〈㚑
8a/So8	ぃ㑥
8a/bE	ぃ】
8a/bE/lE	ぃ】ぅ
8a/bE/lE/yE	ぃ】ぅ〤
8a/bES	ぃ㌕
8a/lEb	ぃ㔙
8a/li/baf	ぃも䄖
8a/nE	ぃ〆
8a/nu/nE	ぃㄳ〆
8a/nu/nES	ぃㄳ㉳
8a/nu/na/Sun	ぃㄳ〸㆒
8a/nu/naS	ぃㄳ㉒
8a/nu/ni	ぃㄳこ
8a/nu/no	ぃㄳㆈ
8a/nun	ぃ㞈
8a/ti	ぃㅔ
8a/ti/E	ぃㅔ【
8a/xaz	ぃ䤀
8a/yE/8&/ro	ぃ〤ㄷ〹
8a/yE8	ぃ䊒
8a/yE8/ha/ro	ぃ䊒と〹
8a/yEb	ぃ䌂
8a/zE	ぃㄕ
8ab	ㅅ
8ab/l&/m&S	ㅅ㌧㍧
8ab/l&/mE	ㅅ㌧ㆂ
8ab/l&/mE/ha	ㅅ㌧ㆂと
8abE	㤲
8ah/r&/ma	䥃㈀〖
8ar/c&m	䁡䁢
8ar/cE	䁡で
8ar/ca	䁡ㅘ
8ar/cam	䁡䁣
8arc	䁠
8e/bES	䆘㌕
8e/ci	䆘ぉ
8e/ci/ci	䆘ぉぉ
8e/ciS	䆘㔨
8e/m&/tE	䆘ばつ
8e/m&t	䆘㝡
8e/rE	䆘〕
8eb	㡹
8er	䈒
8i/ya/f&/Sun	㌶ㄈㅂ㆒
8i/ya/f&S	㌶ㄈ䀁
8i/ya/fE/yE	㌶ㄈ㈷〤
8o/da/i	㖀〴〷
8o/l&m	㖀ㆄ
8o/li	㖀も
8o/lo/pi	㖀㌳ㄉ
8o/lom/b&S	㖀㤩㤀
8o/lom/bE	㖀㤩】
8o/lom/bE/hE	㖀㤩】ご
8o/lop	㖀䀅
8o/rES	㖀て
8o/rES/n&/kon	㖀てゔけ
8o/ru/bi	㖀ㄹち
8o/rub	㖀䙩
8o/sE	㖀〇
8od/8o/da	㕹㖀〴
8od/8od	㕹㕹
8od/8od/8o/da/E	㕹㕹㖀〴【
8od/r&/t&m	㕹㈀ㅨ
8od/r&/tES	㕹㈀㉩
8ofl	䝱
8ol	㠓
8ol/8ol	㠓㠓
8ol/do/ri	㠓〰〵
8om/8o/mE/yE	䝔㖀ㆂ〤
8on/c&st	䄙䄠
8or	よ
8or/8or	よよ
8or/ba/nE	よ〱〆
8or/ba/nEt	よ〱ㄲ
8or/bu/nE	よら〆
8or/bu/nE/S&m	よら〆㆑
8or/bu/nE/tun	よら〆ㄖ
8or/bu/nES	よら㉳
8or/bu/nEt	よらㄲ
8or/mE	よㆂ
8or/mE/s&b/zi	よㆂ㐹ㄵ
8or/s&m	よ㑷
8or/sE	よ〇
8or/sEt	よㅸ
8or/so	よㅇ
8orbunEt	䁄
8ors	䚂
8ot/si	䐠々
8u	㖒
8u/8u/li/8u/8ul	㖒㖒も㖒䄃
8u/8u/li/8u/lul	㖒㖒も㖒䡖
8u/8u/ri	㖒㖒〵
8u/8u/ri/y&n	㖒㖒〵䀸
8u/l&/ro	㖒㌧〹
8u/l&m	㖒ㆄ
8u/l&n	㖒㍕
8u/lE	㖒ぅ
8u/la	㖒〢
8u/la/yE	㖒〢〤
8u/la/yi	㖒〢㆕
8u/li	㖒も
8u/lo	㖒㌳
8u/ri/yE	㖒〵〤
8u/yE	㖒〤
8ul	䄃
8ul/bi/ya/bu/ni	䄃ちㄈらこ
8ul/pe/k&r	䄃㈁㉲
8ul/xob	䄃〶
8ur/ba/8&/mun	㊀〱ㄷだ
8ur/ba/8E	㊀〱㊁
8ur/ba/8E/ha/ro	㊀〱㊁と〹
8ur/ba/8E/yE	㊀〱㊁〤
8ur/tE/Sun	㊀つ㆒
8ur/tES	㊀㉩
8urt	㥙
E	【
E/Ga/rE	【〉〕
E/Ga/z&/tun	【〉ㄥㄖ
E/Ga/zE	【〉ㄕ
E/d&/rE	【㄰〕
E/dE	【あ
E/da/mE	【〴ㆂ
E/da/mE/yE	【〴ㆂ〤
E/fE/So	【㈷〈
E/fa/dE	【㕈あ
E/ko	【ぇ
E/ko/no/mik	【ぇㆈ䉐
E/la/hi	【〢ょ
E/lam	【㎔
E/lan	【㍒
E/li/z&/bEt	【もㄥ㐥
E/li/za/bE/tE	【も㎇】つ
E/li/za/bEt	【も㎇㐥
E/mad	【䚔
E/mel	【䉵
E/nEr/Gi	【㌅㌆
E/nEr/Gim	【㌅㠶
E/sE/mE/sES	【〇ㆂ㐃
E/sE/mEs	【〇ㄅ
E/sE/mEs/ka/ri	【〇ㄅ㐶〵
E/tE/fa/8&n	【つ㕈㚉
E/tE/fa/8E	【つ㕈㊁
E/tE/fa/8E/h&/m&/Sun	【つ㕈㊁ㄱば㆒
E/tE/fa/8a	【つ㕈ぃ
E/tE/fa/8a/yi	【つ㕈ぃ㆕
E/tE/fa/8i	【つ㕈㌶
E/tE/fa/8i/yE	【つ㕈㌶〤
E/tE/fa8	【つ䈡
E/tE/la	【つ〢
E/tE/la/yE	【つ〢〤
E/tE/ma/l&n	【つ〖㍕
E/tE/ma/lES	【つ〖㈱
E/tE/sal	【つ㈇
E/za/fE	【㎇㈷
EG/ba/r&n	㝐〱へ
EG/ba/ri	㝐〱〵
EG/dE/ha	㝐あと
EG/dE/ha/E	㝐あと【
EG/dE/ha/h&/ro	㝐あとㄱ〹
EG/dE/ha/ha	㝐あとと
EG/dE/hast	㝐あ㠁
EG/ra	㝐ㅹ
EG/ra/ha	㝐ㅹと
EG/ra/yE	㝐ㅹ〤
EG/raS	㝐ㄐ
ES/8E	㑃㊁
ES/8E/Sun	㑃㊁㆒
ES/8al	㑃㒄
ES/ga/lE	㑃㍡ぅ
ES/ga/lES	㑃㍡㈱
ES/ga/li	㑃㍡も
ES/gal	㑃㚐
ES/ka/li	㑃㐶も
ES/mE/So	㑃ㆂ〈
ES/ra/8i	㑃ㅹ㌶
ES/tE/ba	㑃つ〱
ES/tE/ba/ha	㑃つ〱と
ES/tE/ba/hi	㑃つ〱ょ
ES/tE/ba/hi/yE	㑃つ〱ょ〤
ES/tE/ba/mi/za/ni	㑃つ〱〃㎇こ
ES/tE/bah	㑃つ㢖
ES/tE/bast	㑃つ㦓
ES/tE/ha	㑃つと
ES/ti/ya8	㑃ㅔ䕓
ES8	䠢
Eb	㑩
Eb/ra/hi/mi	㑩ㅹょ〃
Eb/tE/ka/ri	㑩つ㐶〵
Ec	㚈
Ef	㕓
Ef/tE/za	㕓つ㎇
Ef/tE/za/yi	㕓つ㎇㆕
Eh	㜇
Eh/sa/sE	㜇㈆〇
Eh/sas	㜇䆔
Eh/tE/mal	㜇つ㔹
Eh/ti/ya/Gi	㜇ㅔㄈ㌆
Eh/ti/yaG	㜇ㅔ䈣
Eh/ti/yat	㜇ㅔ㥶
Eks/tE/ra	䎃つㅹ
Eks/tE/ra/yE	䎃つㅹ〤
Eks/tE/sas	䎃つ䆔
El	㕗
El/mi/ra	㕗〃ㅹ
Elm	䕖
Em	㈉
Em/S&/bi/yE	㈉㍸ち〤
Em/S&b	㈉㎂
Em/kan	㈉㜴
Em/ru/z&m	㈉ㄹ㑶
Em/ruz	㈉㈐
Em/sal	㈉㈇
Em/tE/ha/nES	㈉つと㉳
Em/tE/ha/na/Sun	㈉つと〸㆒
Em/tE/ha/na/mun	㈉つと〸だ
Em/tE/han	㈉つㅉ
Em/ti/ya/zES	㈉ㅔㄈㄧ
Em/ti/ya/zEt	㈉ㅔㄈ㚄
Em/ti/yaz	㈉ㅔ㐰
En	㉠
En/8&/da	㉠ㄷ〴
En/8&/di	㉠ㄷび
En/8&d	㉠㖓
En/8&d/ri	㉠㖓〵
En/8&dr	㉠㉡
En/8E/la/bE	㉠㊁〢】
En/8E/lab	㉠㊁䂈
En/am	㉠䊃
En/dax/t&n	㉠ㅧ㍔
En/dax/tE	㉠ㅧつ
En/dax/tES	㉠ㅧ㉩
En/dax/ti	㉠ㅧㅔ
En/daxt	㉠㙅
En/gE/lEs/tan	㉠ぴ䔣㎖
En/gar	㉠㢗
En/gli/si	㉠䤒々
En/gli/si/yE	㉠䤒々〤
En/san	㉠䍘
En/tE/xa/bE	㉠つし】
En/tE/xa/ba/tE	㉠つし〱つ
En/tE/xab	㉠つ㑦
En/tE/za/ri	㉠つ㎇〵
En/tE/zar	㉠つ〠
Er/sal	㝰㈇
Er/te/fa	㝰㜃㕈
Es	㈸
Es/f&n/dE	㈸㔀あ
Es/f&n/di/ya/r&m	㈸㔀びㄈ㄄
Es/f&n/di/yar	㈸㔀び㆐
Es/f&nd	㈸䖃
Es/kE/lE	㈸ㄢぅ
Es/kE/lE/tE	㈸ㄢぅつ
Es/kE/lEt	㈸ㄢ㆔
Es/ke/t&n	㈸㕖㍔
Es/ke/tE	㈸㕖つ
Es/ke/ti	㈸㕖ㅔ
Es/ke/ti/yE	㈸㕖ㅔ〤
Es/ket	㈸㈹
Es/ket/bord	㈸㈹㈳
Es/ki	㈸〥
Es/kul	㈸䑱
Es/la/hi/yE/ha	㈸〢ょ〤と
Es/la/mi	㈸〢〃
Es/la/mi/yE	㈸〢〃〤
Es/lam	㈸㎔
Es/m&m	㈸㍲
Es/mE	㈸ㆂ
Es/mE/SE	㈸ㆂㅠ
Es/mE/Sun	㈸ㆂ㆒
Es/mE/to	㈸ㆂ〙
Es/mES	㈸㊒
Es/mEs	㈸ㄅ
Es/mEt	㈸㞗
Es/ma	㈸〖
Es/ma/Sun	㈸〖㆒
Es/ma/il	㈸〖䥶
Es/ma/yE	㈸〖〤
Es/mar/ti/z&m	㈸㉧ㅔ㑶
Es/mar/ti/zE	㈸㉧ㅔㄕ
Es/mar/tis	㈸㉧䤱
Es/mar/tiz	㈸㉧㑳
Es/mi	㈸〃
Es/pE/re	㈸ㄣ㚅
Es/pE/re/E	㈸ㄣ㚅【
Es/pa/ro	㈸〘〹
Es/panG/ba/bE	㈸䅹〱】
Es/panG/bab	㈸䅹㤥
Es/pay/dEr/m&n	㈸䈓䈔㄁
Es/pi/di	㈸ㄉび
Es/po/ro	㈸べ〹
Es/po/ro/ro	㈸べ〹〹
Es/pro/ro	㈸䌸〹
Es/rar	㈸㔴
Es/t&x/rE	㈸㆙〕
Es/t&xr	㈸㤢
Es/tE/fa/dE	㈸つ㕈あ
Es/tE/ra/h&/tEt	㈸つㅹㄱ㕶
Es/tE/ra/h&t	㈸つㅹ㝢
Es/tE8/bal	㈸䔠㠗
Es/tE8/lal	㈸䔠㦆
Es/tEps	㈸㠸
Es/tEs/na/yi	㈸㢑〸㆕
Es/tan/dar/dES	㈸㎖㐑㈴
Es/tan/dard	㈸㎖䉤
Es/tan/dard/ha/yE	㈸㎖䉤と〤
Es/te/SEn	㈸㜃㜄
Es/to/pES	㈸〙䉁
Es/top	㈸䢑
Es/tuk	㈸䎇
Eskul	䥈
Esm	䀗
EstESEn	㠹
Ez/dE/vaG	䎈あ䎐
Ez/de/vaG	䎈䎉䎐
G&/8&/la	㆗ㄷ〢
G&/NE	㆗㙗
G&/NEz/bo/ro	㆗䌩ぶ〹
G&/Ni/d&n	㆗䐈ぱ
G&/b&S	㆗㤀
G&/b&st	㆗㙖
G&/b&t	㆗㡩
G&/bE	㆗】
G&/bE/ha	㆗】と
G&/be/E	㆗ㅲ【
G&/di/d&/ro	㆗び㄰〹
G&/di/d&m	㆗びㅕ
G&/di/d&n	㆗びぱ
G&/di/dE	㆗びあ
G&/di/dE/to	㆗びあ〙
G&/did	㆗㌦
G&/f&/ri	㆗ㅂ〵
G&/f&r	㆗㊔
G&/f&r/za/dE	㆗㊔㎇あ
G&/h&/n&/mE	㆗ㄱゔㆂ
G&/h&/n&/mi/yE	㆗ㄱゔ〃〤
G&/h&/tE	㆗ㄱつ
G&/ha/ni	㆗とこ
G&/ha/ni/yE	㆗とこ〤
G&/han/g&r/da	㆗ㅉ㈥〴
G&/han/g&rd	㆗ㅉ䅢
G&/kE	㆗ㄢ
G&/ki	㆗〥
G&/lEb	㆗㔙
G&/m&n	㆗㄁
G&/mE	㆗ㆂ
G&/mES	㆗㊒
G&/mi/ya/ti/yE	㆗〃ㄈㅔ〤
G&/ri/yan	㆗〵㍷
G&/ro/sa/8i/lE	㆗〹㈆㌶ぅ
G&/ro/sa/8il	㆗〹㈆㝆
G&/va/b&/mo	㆗ゃ〡㈓
G&/va/b&m	㆗ゃ㙢
G&/va/bE	㆗ゃ】
G&/va/bE/in/Ga	㆗ゃ】。〉
G&/va/bES	㆗ゃ㌕
G&/va/bEt	㆗ゃ㐥
G&/va/bi	㆗ゃち
G&/va/hE/ra/tE	㆗ゃごㅹつ
G&/va/hE/rat	㆗ゃごㄦ
G&/vab	㆗㖙
G&/vi/d&/nE	㆗㒇㄰〆
G&/vu/n&m	㆗㞐〗
G&/vu/nE	㆗㞐〆
G&/vu/niS	㆗㞐㊇
G&/vun	㆗䙃
G&/zab	㆗䔗
G&/zi/re/E	㆗ㄵ㚅【
G&N/Gu	䘨㄀
G&N/Gu/yE	䘨㄀〤
G&S/n&	㦑ゔ
G&S/nE	㦑〆
G&Sn	䖇
G&d/v&/lE	㡳㈶ぅ
G&d/v&l	㡳ㅁ
G&k	㖇
G&lb	䍅
G&m	㍈
G&m/goft	㍈ㅷ
G&m/kE	㍈ㄢ
G&n	㙳
G&n/g&/l&m	㙳ㄠㆄ
G&n/g&/lE	㙳ㄠぅ
G&n/g&/la	㙳ㄠ〢
G&n/g&/la/yE	㙳ㄠ〢〤
G&n/g&/li	㙳ㄠも
G&n/g&/lim	㙳ㄠ䜰
G&n/g&l	㙳䈑
G&n/g&m	㙳㍑
G&ng&l	䝑
GE/d&n	㌲ぱ
GE/di	㌲び
GE/di/Sun	㌲び㆒
GE/lE	㌲ぅ
GE/li/8&S	㌲も䒕
GE/li/8e/E	㌲も䆘【
GE/lo	㌲㌳
GE/lo/S&m	㌲㌳㆑
GE/lo/t&/r&m	㌲㌳ㄒ㄄
GE/lo/t&/rE	㌲㌳ㄒ〕
GE/lo/t&/ri	㌲㌳ㄒ〵
GE/lo/t&r	㌲㌳〄
GE/lo/yE	㌲㌳〤
GE/lo/yi	㌲㌳㆕
GE/loS	㌲䕹
GE/lot	㌲㒙
GE/na/ba/li	㌲〸〱も
GE/ri	㌲〵
GE/tE	㌲つ
GEbEto	䝨
GEl/dE	䘴あ
GEl/dES	䘴㈴
GEld	䎗
GEn/sE	䉱〇
GEn/sE/Sun	䉱〇㆒
GEn/sa	䉱㈆
GEn/sa/yi	䉱㈆㆕
GEr	㜡
GEr/z&/ni	㜡ㄥこ
GEst	䍆
Ga	〉
Ga/SE	〉ㅠ
Ga/So	〉〈
Ga/Sun	〉㆒
Ga/dE/ha/yE	〉あと〤
Ga/da/rE	〉〴〕
Ga/dar/t&/rE	〉㐑ㄒ〕
Ga/du	〉ㄩ
Ga/du/E	〉ㄩ【
Ga/du/g&/r&/ro	〉ㄩㄠ㈀〹
Ga/du/g&/r&m	〉ㄩㄠ㄄
Ga/du/g&/r&n	〉ㄩㄠへ
Ga/du/g&/rE	〉ㄩㄠ〕
Ga/du/g&/ra	〉ㄩㄠㅹ
Ga/du/g&/ra/yE	〉ㄩㄠㅹ〤
Ga/du/g&/ri	〉ㄩㄠ〵
Ga/du/g&/ri/S&m	〉ㄩㄠ〵㆑
Ga/du/g&/ri/yE	〉ㄩㄠ〵〤
Ga/du/g&/rim	〉ㄩㄠㆅ
Ga/du/g&r	〉ㄩ㈥
Ga/du/i	〉ㄩ〷
Ga/du/i/y&n	〉ㄩ〷䀸
Ga/du/i/yE	〉ㄩ〷〤
Ga/du/ro	〉ㄩ〹
Ga/du/to	〉ㄩ〙
Ga/du/yE	〉ㄩ〤
Ga/duS	〉䚃
Ga/ha/yE	〉と〤
Ga/haS	〉㉰
Ga/k&/tEt	〉ㅖ㕶
Ga/lE/b&d	〉ぅ㄂
Ga/lE/bE	〉ぅ】
Ga/lE/ba/si	〉ぅ〱々
Ga/lE/ba/sit	〉ぅ〱㠵
Ga/lE/bi	〉ぅち
Ga/lE/bi/yE	〉ぅち〤
Ga/lEb	〉㔙
Ga/lEb/t&r	〉㔙〄
Ga/mo/zi	〉㈓ㄵ
Ga/mo/zi/yE	〉㈓ㄵ〤
Ga/n&m	〉〗
Ga/nE	〉〆
Ga/nE/8u/lE	〉〆㖒ぅ
Ga/no	〉ㆈ
Ga/ru	〉ㄹ
Ga/ru/yE	〉ㄹ〤
Ga/yE	〉〤
Ga/yE/z&/So	〉〤ㄥ〈
Ga/yE/z&/ro	〉〤ㄥ〹
Ga/yE/z&/to	〉〤ㄥ〙
Ga/yE/z&S	〉〤ㅓ
Ga/yE/z&m	〉〤㑶
Ga/yE/z&st	〉〤ㄙ
Ga/yE/zE	〉〤ㄕ
Ga/yE/zE/ha/yE	〉〤ㄕと〤
Ga/yE/zE/hat	〉〤ㄕ㕂
Ga/yE/zE/yE	〉〤ㄕ〤
Ga/yE/zE/yi	〉〤ㄕ㆕
Ga/yES	〉㥒
Ga/yi	〉㆕
Ga/yi/zE	〉㆕ㄕ
GaS	㊂
GaS/nE	㊂〆
Gam	䀈
Gan	㍅
Gan/8a/li	㍅ぃも
Gan/8u/l&/ro	㍅㖒㌧〹
Gan/8u/lE	㍅㖒ぅ
Gan/8u/lE/&m	㍅㖒ぅ〓
GanE	䝧
GangulE	䔷
Gast	㉵
Gat	㠀
Ge	㕕
Gens	䙷
Gi	㌆
Gi/8i	㌆㌶
Gi/SE/to	㌆ㅠ〙
Gi/SEt	㌆㕁
Gi/Si	㌆げ
Gi/bE	㌆】
Gi/bES	㌆㌕
Gi/baS	㌆㐓
Gi/g&/r&m	㌆ㄠ㄄
Gi/g&/rE	㌆ㄠ〕
Gi/g&/rE/to	㌆ㄠ〕〙
Gi/mE	㌆ㆂ
Gi/mi	㌆〃
Gi/nEt	㌆ㄲ
Gi/pE	㌆ㄣ
Gi8	㦇
GiS	㔖
Gin/gi/lE	㡃んぅ
Gip	䝈
Go/da	㒗〴
Go/da/p&r/c&/mE	㒗〴㖐㙈ㆂ
Go/h&/rES	㒗ㄱて
Go/h&/ri/yan	㒗ㄱ〵㍷
Go/i/di	㒗〷び
Go/kEt	㒗㊑
Go/lo	㒗㌳
Go/m&st	㒗䍱
Go/mE	㒗ㆂ
Go/nu/bE	㒗ㄳ】
Go/nub	㒗䐅
Go/yi/d&n	㒗㆕ぱ
Go/yi/dE	㒗㆕あ
Gob/ran	䀷㔁
Gok	䘓
Gom/Go/mE	䐃㒗ㆂ
Gom/hu/ri	䐃㌨〵
Gom/l&/r&m	䐃㌧㄄
GorG	䍣
Gos/tE/Gu	䉆つ㄀
Gos/to/Gu	䉆〙㄀
Goz	䐘
Goz/vE	䐘㔈
Gu/G&/ro	㄀㆗〹
Gu/G&st	㄀䡒
Gu/G&t	㄀䜔
Gu/GE	㄀㌲
Gu/GE/ha	㄀㌲と
Gu/GE/ha/So	㄀㌲と〈
Gu/GE/ha/yi	㄀㌲と㆕
Gu/GE/hast	㄀㌲㠁
Gu/GE/hat	㄀㌲㕂
Gu/GE/m&n	㄀㌲㄁
Gu/GE/nok/t&/la	㄀㌲㙒ㄒ〢
Gu/GE/nok/t&/la/yi	㄀㌲㙒ㄒ〢㆕
Gu/GE/ti/8i/ya	㄀㌲ㅔ㌶ㄈ
Gu/GE/yi	㄀㌲㆕
Gu/GE/z&r/di	㄀㌲㖑び
Gu/GE/z&r/di/yE	㄀㌲㖑び〤
Gu/Ge/E	㄀㕕【
Gu/Gu	㄀㄀
Gu/SE	㄀ㅠ
Gu/gu/l&m	㄀〒ㆄ
Gu/li/dE	㄀もあ
Gu/li/dE/ha	㄀もあと
Gu/li/dE/ha/ro	㄀もあと〹
Gu/n&m	㄀〗
Gu/nE	㄀〆
Gu/nEt	㄀ㄲ
Gu/ni	㄀こ
Gu/ni/yo/rE	㄀こ㊕〕
Gu/rE	㄀〕
Gu/rES	㄀て
Gu/ra/b&m	㄀ㅹ㙢
Gu/ra/bEt	㄀ㅹ㐥
Gu/ra/yE	㄀ㅹ〤
Gu/ra/yi	㄀ㅹ㆕
Gu/rab	㄀㌔
Gu/ri	㄀〵
Gu/ri/yE	㄀〵〤
GuS	䌐
GuS/Gu/Si	䌐㄀げ
Gub	䠓
Gun	ㄔ
Gur	㥓
Gur/va/Gur	㥓ゃ㥓
Guri	㡗
LEn/gE/yE	䠙ぴ〤
M	ㄨ
S	㦘
S&/b&/hE	㍸〡ご
S&/b&/kE	㍸〡ㄢ
S&/b&h	㍸㑀
S&/b&m	㍸㙢
S&/bE	㍸】
S&/bE/xer	㍸】㝂
S&/bES	㍸㌕
S&/ba	㍸〱
S&/ba/yE	㍸〱〤
S&/bi/E	㍸ち【
S&/bi/h&n	㍸ち㐈
S&/bi/hE	㍸ちご
S&/bi/hE/SE	㍸ちごㅠ
S&/bi/hE/a	㍸ちご〧
S&/bi/hES	㍸ちㆇ
S&/bi/yE	㍸ち〤
S&/bo	㍸ぶ
S&/did	㍸㌦
S&/fi/nE/yE	㍸㉥〆〤
S&/hid	㍸㡸
S&/li/li	㍸もも
S&/ma	㍸〖
S&/ma/yE	㍸〖〤
S&/ra/rEh	㍸ㅹ䥰
S&/si/ya/tE	㍸々ㄈつ
S&/tE	㍸つ
S&/tE/ha	㍸つと
S&/tE/ha/yE	㍸つと〤
S&b	㎂
S&b/ha	㎂と
S&b/ha/yE	㎂と〤
S&h/rE	㖗〕
S&h/rEt	㖗㑣
S&h/ra/yE	㖗ㅹ〤
S&h/ri	㖗〵
S&h/ri/v&/rE	㖗〵㈶〕
S&h/ri/v&r	㖗〵㍉
S&hr	䉗
S&hr/da/ri	䉗〴〵
S&hr/ha	䉗と
S&hr/v&nd	䉗䔧
S&hr/zad	䉗㦁
S&hriv&rE	䠠
S&k	㜨
S&l	㦗
S&l/va/r&/kE	㦗ゃ㈀ㄢ
S&l/va/r&/kEt	㦗ゃ㈀㊑
S&l/va/r&/ki	㦗ゃ㈀〥
S&l/va/r&k	㦗ゃ䖔
S&l/va/rE/to	㦗ゃ〕〙
S&l/va/rEt	㦗ゃ㑣
S&l/var	㦗㘕
S&l/var/to	㦗㘕〙
S&m	㆑
S&m/Si/r&/mo	㆑げ㈀㈓
S&m/Si/rE/mun	㆑げ〕だ
S&m/Si/rES	㆑げて
S&m/Si/rEt	㆑げ㑣
S&m/Sir	㆑㊃
S&m/po	㆑べ
S&n	む
S&n/Ga8	む䐨
S&n/bE	む】
S&n/bE/ha	む】と
S&n/bE/yE	む】〤
S&n/gu/lE	む〒ぅ
S&n/gul	む㠃
S&r/b&/tE	䈐〡つ
S&r/b&t	䈐㡩
S&r/tE	䈐つ
S&r/ti	䈐ㅔ
S&r/va/rE	䈐ゃ〕
S&r/va/rEt	䈐ゃ㑣
S&r/za/dE	䈐㎇あ
S&r/zad	䈐㦁
S&rG	㝥
S&rt	䠹
S&s/tE	㔃つ
S&s/ta	㔃ゅ
S&st	㖃
S&t/r&n/GE	㝸へ㌲
S&t/r&nG	㝸䊐
S&xs	䦐
SE/fild	ㅠ㢘
SE/gEf/t&n/giz	ㅠ䑦㍔䑧
SE/k&/m&m	ㅠㅖ㍲
SE/k&/mE	ㅠㅖㆂ
SE/k&/mE/to	ㅠㅖㆂ〙
SE/k&/mES	ㅠㅖ㊒
SE/k&/mEt	ㅠㅖ㞗
SE/k&/mu	ㅠㅖ㉀
SE/k&/rES	ㅠㅖて
SE/k&m	ㅠ㉘
SE/k&r	ㅠ㉲
SE/k&s/t&st	ㅠ㡈䌕
SE/k&s/tE	ㅠ㡈つ
SE/k&s/tE/yE	ㅠ㡈つ〤
SE/k&s/tES	ㅠ㡈㉩
SE/k&s/tEt	ㅠ㡈㕶
SE/k&st	ㅠ㜕
SE/ka/y&t	ㅠ㐶㉦
SE/kun/d&m	ㅠ㝅ㅕ
SE/kun/di	ㅠ㝅び
SE/kund	ㅠ䥕
SE/l&x/tE	ㅠ㙀つ
SE/li/kaS	ㅠも㌘
SE/li/kat	ㅠも䈅
SE/lik	ㅠ㝄
SE/mor/di	ㅠ㌰び
SE/mord	ㅠ㘅
SE/nEl	ㅠ䈉
SE/na	ㅠ〸
SE/na/v&n/dE/gan	ㅠ〸䚒あ䚑
SE/na/v&nd	ㅠ〸䔧
SE/nax/tE	ㅠ䀢つ
SE/ni/d&m	ㅠこㅕ
SE/ni/dE	ㅠこあ
SE/ni/di	ㅠこび
SE/ni/dim	ㅠこ㈖
SE/ni/din	ㅠこ㌒
SE/nid	ㅠ㙆
SE/nit/sEl	ㅠ㡧㦈
SE/rE	ㅠ〕
SE/rE/So	ㅠ〕〈
SE/rE/kE	ㅠ〕ㄢ
SE/rE/ki	ㅠ〕〥
SE/rE/tE	ㅠ〕つ
SE/rES	ㅠて
SE/rEk	ㅠ㢙
SE/rEt	ㅠ㑣
SE/ra/yE	ㅠㅹ〤
SE/ri	ㅠ〵
SE/tab	ㅠ㕄
SEk/l&/kE	㆓㌧ㄢ
SEk/l&k	㆓㔑
SEk/lE	㆓ぅ
SEk/lES	㆓㈱
SEk/lEt	㆓㆔
SEk/li	㆓も
SEk/li/E	㆓も【
SEm/S&/ka	䎆㍸㐶
SEr	㎒
SEr/k&t	㎒㍢
SEr/vin	㎒䉔
SEr/vud	㎒䝇
Sa/E/ra/yE	〨【ㅹ〤
Sa/dE	〨あ
Sa/di	〨び
Sa/gErd	〨㉐
Sa/hE	〨ご
Sa/hE/Sun	〨ご㆒
Sa/hEt	〨㍐
Sa/ki	〨〥
Sa/mE	〨ㆂ
Sa/mE/lE	〨ㆂぅ
Sa/mE/mun	〨ㆂだ
Sa/mE/to	〨ㆂ〙
Sa/mES	〨㊒
Sa/mEt	〨㞗
Sa/mi/ya/to	〨〃ㄈ〙
Sa/nE	〨〆
Sa/x&/r&m	〨㆖㄄
Sa/xE	〨㈙
Sa/xE/ha	〨㈙と
Sa/xE/ha/yE	〨㈙と〤
Sa/xE/yE	〨㈙〤
Sa/xE/yi	〨㈙㆕
Sa/xES	〨㌃
Sa/xa	〨し
Sa/xa/yi	〨し㆕
Sa/xaS	〨䠵
Sa/xan	〨ひ
Sa/y&/d&m	〨㍗ㅕ
Sa/y&/dE	〨㍗あ
Sa/y&d	〨ㅦ
Sa/ya/nE	〨ㄈ〆
Sa/yan	〨㍷
Sa/zi	〨ㄵ
Sad	㕴
Sad/zi	㕴ㄵ
Sah	䍰
Sah/ka/ra/yi	䍰㐶ㅹ㆕
Sah/kar	䍰㈣
Sah/na/m&st	䍰〸䍱
Sah/na/mE	䍰〸ㆂ
Sah/na/mE/yE	䍰〸ㆂ〤
Sah/za/dE	䍰㎇あ
Sah/za/dE/ha	䍰㎇あと
Sah/za/dE/hast	䍰㎇あ㠁
Sal	㙩
Sam	㙲
San/si	㞙々
Sans	䜉
Sar/kE	㜐ㄢ
Sax	㑤
Sax/t&/la	㑤ㄒ〢
Saz/dE	㡂あ
Saz/di	㡂び
Se/tu/n&/kE	㘷ㅡゔㄢ
Se/tu/n&k	㘷ㅡ㑐
Se/tu/n&n	㘷ㅡふ
Se/tu/nE	㘷ㅡ〆
Se/tu/na	㘷ㅡ〸
Se/tu/ni	㘷ㅡこ
Se/tu/ni/ya	㘷ㅡこㄈ
Se/tu/ni/ya/i	㘷ㅡこㄈ〷
Se/tu/ni/yaS	㘷ㅡこ㐸
Se/tun	㘷ㄖ
Se/tun/ni/ya/yE	㘷ㄖこㄈ〤
Si	げ
Si/S&/to	げ㍸〙
Si/S&S	げㅥ
Si/S&ro	げ䂗
Si/S&st	げ㖃
Si/S&t	げ㝸
Si/SE	げㅠ
Si/SE/ha/yE	げㅠと〤
Si/SE/i	げㅠ〷
Si/SE/yE	げㅠ〤
Si/SE/yi/&m	げㅠ㆕〓
Si/Si	げげ
Si/So/mi	げ〈〃
Si/af	げ㙶
Si/l&n/gE	げ㍕ぴ
Si/la	げ〢
Si/mi/ya/yi	げ〃ㄈ㆕
Si/mi/ya/yi/So	げ〃ㄈ㆕〈
Si/r&/ro	げ㈀〹
Si/r&m	げ㄄
Si/rE	げ〕
Si/rE/to	げ〕〙
Si/rES	げて
Si/rEt	げ㑣
Si/ra	げㅹ
Si/ra/yE	げㅹ〤
Si/ra/zi	げㅹㄵ
Si/ra/zi/yE	げㅹㄵ〤
Si/ran	げ㔁
Si/ri	げ〵
Si/ri/nE	げ〵〆
Si/ri/na	げ〵〸
Si/ri/ni	げ〵こ
Si/ri/ni/a/yi	げ〵こ〧㆕
Si/ri/ni/ha/yE	げ〵こと〤
Si/ri/ni/yE	げ〵こ〤
Si/ri/ni/ya/yE	げ〵こㄈ〤
Si/rin	げㅃ
Si/ro	げ〹
Si/sE	げ〇
Si/v&/ro	げ㈶〹
Si/vE/yE	げ㔈〤
Si/xan	げひ
SiS	㈒
SiS/s&d	㈒㞄
SiS/ta	㈒ゅ
SiS/tast	㈒㍁
Sim	㕥
Sin	゙
Sir	㊃
Sir/da/l&k	㊃〴㔑
Sir/moz	㊃䍖
So	〈
So/Ga	〈〉
So/Ga/&/tE/Sun	〈〉ㅀつ㆒
So/Ga/&m	〈〉〓
So/Ga/E	〈〉【
So/Ga/i/Sun	〈〉〷㆒
So/Ga/t&/rin	〈〉ㄒㅃ
So/Ga/t&r	〈〉〄
So/Ga/yE	〈〉〤
So/Gan	〈㍅
So/bE/yE	〈】〤
So/ci	〈ぉ
So/d&/nE	〈㄰〆
So/d&/nES	〈㄰㉳
So/d&/ro	〈㄰〹
So/d&m	〈ㅕ
So/d&n	〈ぱ
So/dE	〈あ
So/dE/yi	〈あ㆕
So/dES	〈㈴
So/dEh	〈䕶
So/di	〈び
So/dim	〈㈖
So/din	〈㌒
So/h&/r&m	〈ㄱ㄄
So/h&/rE	〈ㄱ〕
So/ko/la/tE	〈ぇ〢つ
So/ko/la/tEt	〈ぇ〢㕶
So/ko/la/ta	〈ぇ〢ゅ
So/ko/la/ta/r&m	〈ぇ〢ゅ㄄
So/ko/la/ti	〈ぇ〢ㅔ
So/ko/la/ti/ya	〈ぇ〢ㅔㄈ
So/ko/lat	〈ぇ㑹
So/lu/8E	〈ぢ㊁
So/lu8	〈䠇
So/ma	〈〖
So/ma/&m	〈〖〓
So/ma/b&/cE	〈〖〡で
So/ma/bE/Sin	〈〖】゙
So/ma/bE/m&n	〈〖】㄁
So/ma/ba/das/tES	〈〖〱䄨㉩
So/ma/cE	〈〖で
So/ma/daS/ti	〈〖㈂ㅔ
So/ma/ha	〈〖と
So/ma/in	〈〖。
So/ma/lE	〈〖ぅ
So/ma/r&/ro	〈〖㈀〹
So/ma/r&S	〈〖㡢
So/ma/r&st	〈〖㞅
So/ma/rE	〈〖〕
So/ma/rE/ha	〈〖〕と
So/ma/rE/ha/Sun	〈〖〕と㆒
So/ma/rE/ha/ro	〈〖〕と〹
So/ma/rE/haS	〈〖〕㉰
So/ma/rE/yE	〈〖〕〤
So/ma/rE/yi	〈〖〕㆕
So/ma/ro	〈〖〹
So/mal	〈㔹
So/man	〈〩
So/mast	〈㕢
So/mi/nE	〈〃〆
So/ru	〈ㄹ
So/ru/bi/yar	〈ㄹち㆐
So/to/r&/ro	〈〙㈀〹
So/to/rE	〈〙〕
So/tor	〈㉅
So/tor/gom/So/dE/gi	〈㉅㕧〈あん
SoS/ti	䤶ㅔ
Sod	㈵
Sod/So/to/rE	㈵〈〙〕
Sod/b&/lE	㈵〡ぅ
SodE	䝆
Sok/rEt	㘩㑣
Sokr	䄥
Sol	䎀
Sor/tES	㥰㉩
Sort	䁘
Sos/t&/mES	㐦ㄒ㊒
Sos/t&/nE	㐦ㄒ〆
Sos/t&m	㐦ㅨ
Sos/t&n	㐦㍔
Sos/tE	㐦つ
Sos/ti	㐦ㅔ
Sos/tim	㐦㐩
Sos/to/Su/E	㐦〙㐤【
Sost	䤵
Su/in	㐤。
Su/n&/t&m	㐤ゔㅨ
Su/n&S	㐤㔸
Su/n&m	㐤〗
Su/nE	㐤〆
Su/nE/ha/So	㐤〆と〈
Su/rES	㐤て
Su/tE/Sun	㐤つ㆒
Su/xi	㐤㌢
Su/xi/tun	㐤㌢ㄖ
Su/xi/yE	㐤㌢〤
Su/xit	㐤䑸
Sui	㘥
SuiyE	䄳
Suiya	䎔
Sun	㆒
Sunz/d&/hE	㡉㄰ご
Sunz/d&h	㡉㉈
Sunz/d&h/ta	㡉㉈ゅ
Sut	䁁
Un/Ga/ro	㜁〉〹
a	〧
a/8E/b&/tE	〧㊁〡つ
a/8E/b&/tES	〧㊁〡㉩
a/8E/la/nE/yi	〧㊁〢〆㆕
a/8El	〧㔕
a/8a	〧ぃ
a/8a/E	〧ぃ【
a/8a/h&/ra	〧ぃㄱㅹ
a/8a/h&/ro	〧ぃㄱ〹
a/8a/h&st	〧ぃ㉙
a/8a/hE	〧ぃご
a/8a/l&k/l&/kE	〧ぃ㔑㌧ㄢ
a/8a/nist	〧ぃ㈡
a/8a/ru/ba/hE	〧ぃㄹ〱ご
a/8a/yE	〧ぃ〤
a/8a/yi	〧ぃ㆕
a/8o/lES	〧㖀㈱
a/8ol	〧㠓
a/Gi/bi	〧㌆ち
a/Gil/fu/ru/Si	〧䡱䀄ㄹげ
a/SE	〧ㅠ
a/SE/8&/mE	〧ㅠㄷㆂ
a/SE/8&m	〧ㅠㅶ
a/SE/8E	〧ㅠ㊁
a/SE/8E/S&m	〧ㅠ㊁㆑
a/SE/8E/SE	〧ㅠ㊁ㅠ
a/SE/8E/t&m	〧ㅠ㊁ㅨ
a/SE/8ES	〧ㅠ㚗
a/SE8	〧䀀
a/Zan/sE	〧㥤〇
a/b&	〧〡
a/b&m	〧㙢
a/bE	〧】
a/bE/Sun	〧】㆒
a/bE/mun	〧】だ
a/bE/ru	〧】ㄹ
a/bE/ru/ri/zi	〧】ㄹ〵ㄵ
a/bE/ru/ro	〧】ㄹ〹
a/bE/ru/yE	〧】ㄹ〤
a/bE/ruS	〧】ㅰ
a/bE/rum	〧】䂀
a/bES	〧㌕
a/bEt	〧㐥
a/ba/ro	〧〱〹
a/ba/zi	〧〱ㄵ
a/baS	〧㐓
a/bad	〧㑉
a/ban	〧䁕
a/bi	〧ち
a/bi/yE	〧ち〤
a/bi/ya	〧ちㄈ
a/bi/ya/ro	〧ちㄈ〹
a/bi/yat	〧ち㥶
a/bo	〧ぶ
a/bu/bu/bi	〧ららち
a/bu/ha/ni	〧らとこ
a/ca/rES	〧ㅘて
a/car	〧㉇
a/d&/mE	〧㄰ㆂ
a/d&/mE/un	〧㄰ㆂ〣
a/d&/ma	〧㄰〖
a/d&/ma/ro	〧㄰〖〹
a/d&/mam	〧㄰㥖
a/d&/may/E	〧㄰㘴【
a/d&/may/i	〧㄰㘴〷
a/d&/mi	〧㄰〃
a/d&/mo	〧㄰㈓
a/d&/tE	〧㄰つ
a/d&m	〧ㅕ
a/d&m/b&d	〧ㅕ㄂
a/d&m/bE/Si/n&m	〧ㅕ】げ〗
a/d&m/hay/E	〧ㅕ㘰【
a/d&mo	〧䤴
a/d&t	〧ゐ
a/da	〧〴
a/dam/sE	〧㊄〇
a/dams	〧㠕
a/di	〧び
a/di/das	〧び䄨
a/f&/rin	〧ㅂㅃ
a/fi/y&t	〧㉥㉦
a/ga/hi	〧㍡ょ
a/h&N	〧㑡
a/h&N/E	〧㑡【
a/h&N/E/tun	〧㑡【ㄖ
a/h&N/ES	〧㑡㑃
a/h&N/Et	〧㑡䡘
a/h&N/a	〧㑡〧
a/h&N/i	〧㑡〷
a/h&N/z&/nE	〧㑡ㄥ〆
a/h&n	〧㐈
a/h&n/ro/ba	〧㐈〹〱
a/h&n/ro/bast	〧㐈〹㦓
a/hE	〧ご
a/ha	〧と
a/han	〧ㅉ
a/hay	〧㘰
a/hu	〧㌨
a/hum	〧䥒
a/larm	〧䍶
a/li/y&n	〧も䀸
a/li/yax	〧も㜳
a/lma	〧䡢
a/lu	〧ぢ
a/lu/cE	〧ぢで
a/lu/dE	〧ぢあ
a/lu/ha/So	〧ぢと〈
a/m&/d&m	〧ばㅕ
a/m&/d&n	〧ばぱ
a/m&/di	〧ばび
a/m&/dim	〧ば㈖
a/m&/din	〧ば㌒
a/m&d	〧㈰
a/m&d/bo/xor	〧㈰ぶさ
a/ma/d&st	〧〖㎑
a/ma/dE	〧〖あ
a/ma/dE/gi	〧〖あん
a/ma/dE/gi/yE	〧〖あん〤
a/ma/dE/giS	〧〖あ䊀
a/ma/dE/yE	〧〖あ〤
a/ma/daz	〧〖㑠
a/na/na/so	〧〸〸ㅇ
a/na/nas	〧〸䄣
a/na/nas/E	〧〸䄣【
a/na/ta/yE	〧〸ゅ〤
a/par/tE/man	〧㥡つ〩
a/par/tE/man&m	〧㥡つ䔦
a/part/man	〧䕵〩
a/part/man/E	〧䕵〩【
a/r&S	〧㡢
a/rE	〧〕
a/rE/zu	〧〕㖅
a/rE/zut	〧〕䒁
a/rEn/GE	〧㈩㌲
a/rEn/GEt	〧㈩㔐
a/ra/mE/SE	〧ㅹㆂㅠ
a/ra/mE/SE/to	〧ㅹㆂㅠ〙
a/ra/mE/SEt	〧ㅹㆂ㕁
a/ra/mES	〧ㅹ㊒
a/ram	〧㒀
a/ras	〧㍇
a/ri	〧〵
a/ri/y&/nE	〧〵㍗〆
a/ri/y&n	〧〵䀸
a/ri/ya/n&m	〧〵ㄈ〗
a/ri/ya/na	〧〵ㄈ〸
a/ri/ya/yi	〧〵ㄈ㆕
a/rin	〧ㅃ
a/ru/m&m	〧ㄹ㍲
a/rum	〧䂀
a/sE/ma/nE	〧〇〖〆
a/sE/man	〧〇〩
a/sE/mu/nE	〧〇㉀〆
a/sE/mun	〧〇だ
a/sa/yE/SE	〧㈆〤ㅠ
a/san/so/rE	〧䍘ㅇ〕
a/san/sor	〧䍘㡀
a/si	〧々
a/si/yab	〧々䝶
a/su/nE	〧㐣〆
a/sun	〧㡄
a/t&/Si	〧ㄒげ
a/t&/Sin	〧ㄒ゙
a/t&S	〧㚖
a/t&S/nE/Sa/ni	〧㚖〆〨こ
a/t&S/nE/San	〧㚖〆㞙
a/tE/na	〧つ〸
a/ti/Sa/yi	〧ㅔ〨㆕
a/ti/Si	〧ㅔげ
a/tiS	〧㝶
a/tu/sa	〧ㅡ㈆
a/v&/rE	〧㈶〕
a/v&r/d&m	〧㍉ㅕ
a/va	〧ゃ
a/va/ci	〧ゃぉ
a/va/yi	〧ゃ㆕
a/va/z&m	〧ゃ㑶
a/vi/S&n	〧㒇む
a/vi/zu/nE	〧㒇㖅〆
a/vi/zu/nE/Sun	〧㒇㖅〆㆒
a/vi/zu/nEt	〧㒇㖅ㄲ
a/vi/zun	〧㒇㙂
a/vor/d&m	〧㈕ㅕ
a/vor/d&n	〧㈕ぱ
a/vor/dE/ha/rE	〧㈕あと〕
a/vor/di	〧㈕び
a/vord	〧㙠
a/y&n/dE	〧䀸あ
a/yE	〧〤
a/ya	〧ㄈ
a/z&/rE	〧ㄥ〕
a/z&r	〧㖑
a/za/rE	〧㎇〕
a/zad	〧㦁
a/zad/t&r	〧㦁〄
a/zar	〧〠
a/zi	〧ㄵ
aS/8a/la	㒈ぃ〢
aS/8a/li	㒈ぃも
aS/8al	㒈㒄
aS/na	㒈〸
aS/na/haS	㒈〸㉰
aS/p&/z&m	㒈ㅆ㑶
aS/p&/zE	㒈ㅆㄕ
aS/p&/za	㒈ㅆ㎇
aS/p&/zi	㒈ㅆㄵ
aS/p&/zi/&st	㒈ㅆㄵ䁩
aS/p&/zi/yE	㒈ㅆㄵ〤
aS/p&/zit	㒈ㅆ㤅
aS/p&z	㒈㒉
aS/p&z/xu/n&/su/ham	㒈㒉㄃ゔ㐣㜲
aS/p&z/xu/n&/tun	㒈㒉㄃ゔㄖ
aS/p&z/xu/n&st	㒈㒉㄃䂄
aS/p&z/xu/nE	㒈㒉㄃〆
aS/ti	㒈ㅔ
ab	ㅩ
ab/8&n/di	ㅩ㚉び
ab/Gi	ㅩ㌆
ab/Gi/yE	ㅩ㌆〤
ab/Git	ㅩ䢔
ab/GuS	ㅩ䌐
ab/a/na/nas	ㅩ〧〸䄣
ab/guSt	ㅩ䔓
ab/li/mu	ㅩも㉀
ab/li/mut	ㅩも䜆
ab/lu	ㅩぢ
ab/mah/pi/Su/ni	ㅩ㉉ㄉ㐤こ
ab/mi/v&t	ㅩ〃䉹
ab/mi/vE	ㅩ〃㔈
ab/n&/ba/tE	ㅩゔ〱つ
ab/n&/ba/tEt	ㅩゔ〱㕶
ab/n&/ba/ta	ㅩゔ〱ゅ
ab/n&/ba/to	ㅩゔ〱〙
ab/n&/bat	ㅩゔ㐡
ab/n&/m&k	ㅩゔ㉷
ab/por/tE/8al	ㅩ㉕つ㒄
ab/r&N	ㅩ䉑
ab/r&N/E	ㅩ䉑【
ab/r&N/i	ㅩ䉑〷
ad/rE/sE	ㅴ〕〇
ad/rE/sES	ㅴ〕㐃
ad/rEs	ㅴ㚕
af&rin	䞖
af/ri/8a	㙶〵ぃ
af/ri/8am	㙶〵㙷
af/ta/bE	㙶ゅ】
af/ta/bi	㙶ゅち
af/tab	㙶㕄
ah	㤠
ah&n/pa/rE	䐥〘〕
ahan	䑲
ak/ro/b&/tik	䐉〹〡㝲
al&mE	㦉
al/ba/lu	䒂〱ぢ
al/ba/lu/E	䒂〱ぢ【
al/fa	䒂㕈
al/fa/neS	䒂㕈䖒
al/g&lb	䒂䥳
al/tEr/nE/tiveS	䒂㞀〆䡳
am	䊃
am/bo/lans	䊃ぶ䤸
am/pul	䊃㥂
am/ri/ka	䊃〵㐶
am/ri/ka/yi/yE	䊃〵㐶㆕〤
an/ku/mam	䉂㉗㥖
an/ku/mi/rE	䉂㉗〃〕
an/ku/mo	䉂㉗㈓
an/kum	䉂䐐
an/kum/E	䉂䐐【
an/tEn	䉂䁔
an/ti/bi/yu/tik	䉂ㅔち㜀㝲
ankum	䠐
ar	㕘
ar/dE	㕘あ
ar/han	㕘ㅉ
ar/tur	㕘䀰
arE	㈧
ard	䅅
arm	䕘
as/t&r	㐳〄
as/ti/na/to	㐳ㅔ〸〙
ast	䆂
at/dor	㥔㘠
axE	䢁
axe	䉢
ay	㎈
ay/din	㎈㌒
ay/fon	㎈㤴
ay/in/E	㎈。【
ay/lin	㎈ㄤ
ay/rin	㎈ㅃ
ays	倈
b	㕒
b&/8&/l&m	〡ㄷㆄ
b&/8&/lE	〡ㄷぅ
b&/8&/lES	〡ㄷ㈱
b&/8&/lEt	〡ㄷ㆔
b&/8&l	〡㞑
b&/8i	〡㌶
b&/8i/E/yE	〡㌶【〤
b&/8i/y&/So	〡㌶㍗〈
b&/8i/y&/ro	〡㌶㍗〹
b&/8i/y&S	〡㌶㌷
b&/8i/y&st	〡㌶䑒
b&/8i/yE	〡㌶〤
b&/8i/yE/yE/m&n	〡㌶〤〤㄁
b&/bu	〡ら
b&/c&/S&m	〡㙈㆑
b&/c&/Su/no	〡㙈㐤ㆈ
b&/c&/Sun	〡㙈㆒
b&/c&/k&m	〡㙈㉘
b&/c&/ro	〡㙈〹
b&/c&S	〡䍲
b&/c&m	〡䁢
b&/c&n	〡ㆁ
b&/c&st	〡䄠
b&/c&t	〡䡸
b&/cE	〡で
b&/cE/bE/z&/nE/SE	〡で】ㄥ〆ㅠ
b&/cE/dar	〡で㐑
b&/cE/gi	〡でん
b&/cE/gu/nE	〡で〒〆
b&/cE/h&st	〡で㉙
b&/cE/hE	〡でご
b&/cE/ha	〡でと
b&/cE/ha/Sun	〡でと㆒
b&/cE/ha/di/d&m	〡でとびㅕ
b&/cE/ha/ro	〡でと〹
b&/cE/ha/yE	〡でと〤
b&/cE/ha/yi	〡でと㆕
b&/cE/haS	〡で㉰
b&/cE/han	〡でㅉ
b&/cE/p&/s&n/di/yE	〡でㅆ㐙び〤
b&/cE/yE	〡で〤
b&/cE/yi	〡で㆕
b&/cE/zohr	〡で㡥
b&/d&/ki	〡㄰〥
b&/d&/n&m	〡㄰〗
b&/d&/nE	〡㄰〆
b&/d&/nE/Sun	〡㄰〆㆒
b&/d&/nE/mun	〡㄰〆だ
b&/d&/nEt	〡㄰ㄲ
b&/d&k	〡䄢
b&/d&m	〡ㅕ
b&/d&n	〡ぱ
b&/d&x/la/8i	〡䡧〢㌶
b&/dE	〡あ
b&/dE/S&m	〡あ㆑
b&/dE/mun	〡あだ
b&/dES	〡㈴
b&/da/mu/zi	〡〴㉀ㄵ
b&/di	〡び
b&/di/bE	〡び】
b&/di/yE	〡び〤
b&/diS	〡㦕
b&/dit	〡䑘
b&/ha/nE	〡と〆
b&/ha/nE/gi/ri	〡と〆ん〵
b&/ha/r&k	〡と䖔
b&/ha/rE	〡と〕
b&/har	〡㍃
b&/i/dE	〡〷あ
b&/id	〡䅉
b&/l&/d	〡㌧䢒
b&/l&/d&m	〡㌧ㅕ
b&/l&/d&n	〡㌧ぱ
b&/l&/dE	〡㌧あ
b&/l&/di	〡㌧び
b&/l&/dim	〡㌧㈖
b&/l&/din/GaS	〡㌧㌒㊂
b&/l&d	〡㎄
b&/lE	〡ぅ
b&/la	〡〢
b&/la/E	〡〢【
b&/la/ha/yi	〡〢と㆕
b&/la/yE	〡〢〤
b&/la/yi	〡〢㆕
b&/la/yi/y&n	〡〢㆕䀸
b&/lal	〡㦆
b&/last	〡㦔
b&/lu/ci	〡ぢぉ
b&/lu/tE	〡ぢつ
b&/lu/ta	〡ぢゅ
b&/lu/ta/yi	〡ぢゅ㆕
b&/lu/tam	〡ぢ㙹
b&/lut	〡㦒
b&/n&f/SE	〡䉨ㅠ
b&/n&f/SES	〡䉨㎀
b&/n&fS	〡䙇
b&/na/b&/rin	〡〸〡ㅃ
b&/r&n/dE	〡へあ
b&/r&n/dE/Gu/nE	〡へあ㄀〆
b&/r&n/dE/ha	〡へあと
b&/r&n/dE/i	〡へあ〷
b&/r&n/dE/yE	〡へあ〤
b&/rE	〡〕
b&/rE/yE	〡〕〤
b&/rEn/dE	〡㈩あ
b&/rEn/kE	〡㈩ㄢ
b&/rEn/kEm	〡㈩䝷
b&/ra	〡ㅹ
b&/ra/8E	〡ㅹ㊁
b&/ra/8i	〡ㅹ㌶
b&/ra/So/ma/xun/dE	〡ㅹ〈〖めあ
b&/ra/Sun	〡ㅹ㆒
b&/ra/Sun/ci	〡ㅹ㆒ぉ
b&/ra/b&/rE	〡ㅹ〡〕
b&/ra/ci	〡ㅹぉ
b&/ra/d&/r&/mo	〡ㅹ㄰㈀㈓
b&/ra/d&/rE/tE	〡ㅹ㄰〕つ
b&/ra/d&/rES	〡ㅹ㄰て
b&/ra/i/ra/nEt	〡ㅹ〷ㅹㄲ
b&/ra/in/kE	〡ㅹ。ㄢ
b&/ra/mun	〡ㅹだ
b&/ra/rE	〡ㅹ〕
b&/ra/to	〡ㅹ〙
b&/ra/tun	〡ㅹㄖ
b&/ra/v&r/dE	〡ㅹ㍉あ
b&/ra/xa/lE	〡ㅹしぅ
b&/ra/yE	〡ㅹ〤
b&/ra8	〡㑒
b&/raS	〡ㄐ
b&/raS/v&/li	〡ㄐ㈶も
b&/ram	〡㒀
b&/ran/kE	〡㔁ㄢ
b&/rat	〡ㄦ
b&/sE	〡〇
b&/sE/SE	〡〇ㅠ
b&/si	〡々
b&/zi	〡ㄵ
b&/zi/Sun	〡ㄵ㆒
b&/zi/ha	〡ㄵと
b&/zi/ya	〡ㄵㄈ
b&/zi/ya/Sun	〡ㄵㄈ㆒
b&/zi/yaS	〡ㄵ㐸
b&N	䡑
b&b/ra	㌸ㅹ
b&b/ri	㌸〵
b&d	㄂
b&d/GEn/s&m	㄂䉱㑷
b&d/GEn/s&n	㄂䉱㐙
b&d/GEn/sE	㄂䉱〇
b&d/GEn/si	㄂䉱々
b&d/GEns	㄂䌨
b&d/Gu/ri	㄂㄀〵
b&d/Gur	㄂㥓
b&d/b&x/tE	㄂㊙つ
b&d/b&x/ta/nE	㄂㊙ゅ〆
b&d/b&x/ti/ha/yE/bE/b&x/Sid	㄂㊙ㅔと〤】㊙ざ
b&d/b&xt	㄂㜸
b&d/bE/z&/nE	㄂】ㄥ〆
b&d/bE/z&n	㄂】㊖
b&d/bu	㄂ら
b&d/cE	㄂で
b&d/m&/zE	㄂ばㄕ
b&d/t&/rE	㄂ㄒ〕
b&d/t&/ri	㄂ㄒ〵
b&d/t&r	㄂〄
b&d/xEy/lo/xob	㄂䀴㌳〶
b&d/xob	㄂〶
b&dES	㕇
b&h	㑀
b&h/b&h	㑀㑀
b&h/b&h/b&h	㑀㑀㑀
b&h/sE/mun	㑀〇だ
b&hs	䉶
b&l/kE	㝣ㄢ
b&la	䖁
b&laE	䙅
b&layi	䖈
b&le	㤹
b&m	㙢
b&m/bi	㙢ち
b&m/bi/yE	㙢ち〤
b&m/t&/rE	㙢ㄒ〕
b&n/d&/r&/bas	㕲㄰㈀㠥
b&n/d&/rE	㕲㄰〕
b&n/d&/ro	㕲㄰〹
b&n/d&r	㕲ㆉ
b&n/dE	㕲あ
b&n/dES	㕲㈴
b&n/daS	㕲㈂
b&n/di	㕲び
b&nd	㍆
b&r	㈤
b&r/&k/sE	㈤ㄆ〇
b&r/&k/sES	㈤ㄆ㐃
b&r/&ks	㈤ㄓ
b&r/8E	㈤㊁
b&r/8E/mun	㈤㊁だ
b&r/8a	㈤ぃ
b&r/8a/tun	㈤ぃㄖ
b&r/8i	㈤㌶
b&r/b&/ri	㈤〡〵
b&r/c&s/po	㈤䄕べ
b&r/da/r&m	㈤〴㄄
b&r/da/rE	㈤〴〕
b&r/da/ri	㈤〴〵
b&r/daS/ti	㈤㈂ㅔ
b&r/daS/tin	㈤㈂㌥
b&r/daSt	㈤㑑
b&r/dar	㈤㐑
b&r/f&/kE	㈤ㅂㄢ
b&r/fE	㈤㈷
b&r/fa/yE	㈤㕈〤
b&r/fi	㈤㉥
b&r/g&S/t&n	㈤㙨㍔
b&r/g&S/tan/kum	㈤㙨㎖䐐
b&r/g&St	㈤䀂
b&r/g&r/d&m	㈤㈥ㅕ
b&r/g&r/dE	㈤㈥あ
b&r/g&r/di	㈤㈥び
b&r/g&r/du/ni	㈤㈥ㄩこ
b&r/g&r/du/nim	㈤㈥ㄩㄶ
b&r/g&r/dun	㈤㈥㙣
b&r/g&rd	㈤䅢
b&r/gE	㈤ぴ
b&r/ga/yE	㈤㍡〤
b&r/gaS	㈤㠅
b&r/go/zar	㈤い〠
b&r/k&/la	㈤ㅖ〢
b&r/mi/da/r&m	㈤〃〴㄄
b&r/mi/da/r&n	㈤〃〴へ
b&r/mi/da/rE	㈤〃〴〕
b&r/mi/g&r/d&m	㈤〃㈥ㅕ
b&r/mi/g&r/di	㈤〃㈥び
b&r/mi/g&r/dim	㈤〃㈥㈖
b&r/na/mE	㈤〸ㆂ
b&r/na/mE/ha/yE	㈤〸ㆂと〤
b&r/na/mE/yE	㈤〸ㆂ〤
b&r/x&/la/fE	㈤㆖〢㈷
b&r8	䁅
b&r8/b&r8/i	䁅䁅〷
b&rdarE	䝅
b&rf	䙓
b&rfiS	䕂
b&rfiyE	䡄
b&rg	䒓
b&rg&rdunE	䈹
b&s	㐐
b&s/kEt/ba/lis/tE	㐐㊑〱㢀つ
b&s/kEt/bal	㐐㊑㠗
b&s/t&/ni	㐐ㄒこ
b&s/t&/ni/yE	㐐ㄒこ〤
b&s/t&/ni/ya	㐐ㄒこㄈ
b&s/t&/ni/ya/yi	㐐ㄒこㄈ㆕
b&s/t&/niS	㐐ㄒ㊇
b&s/t&/nit	㐐ㄒ㡧
b&s/t&S	㐐㚖
b&s/t&m	㐐ㅨ
b&s/t&s	㐐䐱
b&s/t&st	㐐䌕
b&s/tE	㐐つ
b&s/tE/gi	㐐つん
b&s/tE/ha	㐐つと
b&s/tE/yE	㐐つ〤
b&s/tE/yi	㐐つ㆕
b&s/tE/yi/a	㐐つ㆕〧
b&s/tES	㐐㉩
b&s/ti	㐐ㅔ
b&st	㙖
b&st&niyE	䞙
b&t/m&n	㡩㄁
b&x/SE	㊙ㅠ
b&x/SES	㊙㎀
b&x/Si	㊙げ
b&x/Si/d&n	㊙げぱ
bE/8a/bu/lu/n&m	】ぃらぢ〗
bE/G&/N&n	】㆗㜔
bE/G&/NE	】㆗㙗
bE/G&/Ni	】㆗䐈
bE/G&/Nim	】㆗䌡
bE/Ga/yE	】〉〤
bE/GaS	】㊂
bE/Go/&m	】㒗〓
bE/Go/&n	】㒗ㅐ
bE/Goz	】䐘
bE/S&/ro	】㍸〹
bE/S&m	】㆑
bE/S&m/h&l	】㆑䑰
bE/S&n	】む
bE/SE	】ㅠ
bE/Si	】げ
bE/Si/n&m	】げ〗
bE/Si/n&n	】げふ
bE/Si/nE	】げ〆
bE/Si/ni	】げこ
bE/Si/nim	】げㄶ
bE/Si/nin	】げㅵ
bE/Sim	】㕥
bE/Sin	】゙
bE/Su/r&/mES	】㐤㈀㊒
bE/Su/r&/mEt	】㐤㈀㞗
bE/Su/r&m	】㐤㄄
bE/Su/ri	】㐤〵
bE/Su/ri/mES	】㐤〵㊒
bE/Su/rim	】㐤ㆅ
bE/Su/rin	】㐤ㅃ
bE/Sur	】䂇
bE/b&/r&/mEt	】〡㈀㞗
bE/b&/r&/nE/Sun	】〡㈀〆㆒
bE/b&/r&/tES	】〡㈀㉩
bE/b&/r&m	】〡㄄
bE/b&/r&n	】〡へ
bE/b&/rE	】〡〕
bE/b&/rE/Sun	】〡〕㆒
bE/b&/rES	】〡て
bE/b&/ri	】〡〵
bE/b&/rim	】〡ㆅ
bE/b&/rin	】〡ㅃ
bE/b&n/d&m	】㕲ㅕ
bE/b&n/dE/Sun	】㕲あ㆒
bE/b&n/dES	】㕲㈴
bE/b&n/di	】㕲び
bE/b&n/dim	】㕲㈖
bE/b&nd	】㍆
bE/b&nd/rast	】㍆㈠
bE/b&r	】㈤
bE/b&x/S&m	】㊙㆑
bE/b&x/Sid	】㊙ざ
bE/b&x/Sin	】㊙゙
bE/bE	】】
bE/ba/ba	】〱〱
bE/ba/fim	】〱䍥
bE/bad	】㑉
bE/bi/n&/mES	】ちゔ㊒
bE/bi/n&/mEt	】ちゔ㞗
bE/bi/n&/tES	】ちゔ㉩
bE/bi/n&m	】ち〗
bE/bi/n&n	】ちふ
bE/bi/nE	】ち〆
bE/bi/nES	】ち㉳
bE/bi/na	】ち〸
bE/bi/ni	】ちこ
bE/bi/ni/ya	】ちこㄈ
bE/bi/nid	】ち㙆
bE/bi/nim	】ちㄶ
bE/bi/nin	】ちㅵ
bE/bin	】぀
bE/bo/ri	】ぶ〵
bE/bor	】㐁
bE/c&r/x&m	】㈘㜹
bE/c&r/x&n	】㈘ぁ
bE/c&r/xE	】㈘㈙
bE/c&r/xi	】㈘㌢
bE/c&r/xu/nES	】㈘㄃㉳
bE/c&r/xu/ni	】㈘㄃こ
bE/c&r/xu/niS	】㈘㄃㊇
bE/c&r/xun	】㈘め
bE/c&rx	】䅀
bE/c&s/bun	】䄕㘗
bE/c&s/pE	】䄕ㄣ
bE/c&s/pi	】䄕ㄉ
bE/c&s/pu/n&m	】䄕ゆ〗
bE/c&s/pu/nES	】䄕ゆ㉳
bE/c&s/pu/ni	】䄕ゆこ
bE/c&s/pu/ni/h&r	】䄕ゆこ㈄
bE/c&s/pu/nim	】䄕ゆㄶ
bE/c&s/pu/nin	】䄕ゆㅵ
bE/c&s/pun	】䄕䅷
bE/cE/S&m	】で㆑
bE/cE/S&n	】でむ
bE/cE/lu/n&m	】でぢ〗
bE/cES	】㊉
bE/ci/n&m	】ぉ〗
bE/ci/nin	】ぉㅵ
bE/cin	】䉃
bE/cin/E	】䉃【
bE/d&m	】ㅕ
bE/d&n	】ぱ
bE/d&s/tEt	】゗㕶
bE/dE	】あ
bE/dES	】㈴
bE/di	】び
bE/diS	】㦕
bE/did	】㌦
bE/dim	】㈖
bE/din	】㌒
bE/dir	】㡰
bE/doz/d&m	】㕆ㅕ
bE/doz/dE	】㕆あ
bE/du/n&m	】ㄩ〗
bE/du/ni	】ㄩこ
bE/du/nim	】ㄩㄶ
bE/du/zi	】ㄩㄵ
bE/dun	】㙣
bE/dun/E	】㙣【
bE/f&h/m&m	】㔤㍲
bE/f&h/m&n	】㔤㄁
bE/f&h/mi	】㔤〃
bE/f&h/mim	】㔤㜓
bE/f&r/ma	】㊔〖
bE/f&r/ma/yi	】㊔〖㆕
bE/f&r/ma/yid	】㊔〖㕩
bE/f&r/ma/yin	】㊔〖㊓
bE/fEkr	】う
bE/g&m	】㍑
bE/g&n	】㙡
bE/g&r/d&m	】㈥ㅕ
bE/g&r/d&n	】㈥ぱ
bE/g&r/di	】㈥び
bE/g&r/dim	】㈥㈖
bE/g&rd	】䅢
bE/gE	】ぴ
bE/gEt	】䉥
bE/gi	】ん
bE/gi/r&/mES	】ん㈀㊒
bE/gi/r&/mEt	】ん㈀㞗
bE/gi/r&/tE/Sun	】ん㈀つ㆒
bE/gi/r&/tES	】ん㈀㉩
bE/gi/r&m	】ん㄄
bE/gi/r&n	】んへ
bE/gi/rE	】ん〕
bE/gi/rE/ra/din	】ん〕ㅹ㌒
bE/gi/rES	】んて
bE/gi/ri	】ん〵
bE/gi/riS	】ん㐢
bE/gi/rid/s&/lam	】ん䁆づ㎔
bE/gi/rim	】んㆅ
bE/gi/rin	】んㅃ
bE/gid	】䜵
bE/gim	】ㆆ
bE/gin	】㜩
bE/gir	】ㅱ
bE/gu	】〒
bE/h&	】ㄱ
bE/h&m	】〦
bE/hE/Sun	】ご㆒
bE/hE/mun	】ごだ
bE/hE/tun	】ごㄖ
bE/hES	】ㆇ
bE/hES/bE/GaS	】ㆇ】㊂
bE/hES/in/Gu/ri	】ㆇ。㄀〵
bE/hES/y&/ni	】ㆇ㍗こ
bE/hEm	】㜖
bE/hEt	】㍐
bE/hEt/yE	】㍐〤
bE/ha/lES	】と㈱
bE/hal	】㔔
bE/ham	】㜲
bE/jo	】䌄
bE/jo/yi	】䌄㆕
bE/jun	】䖓
bE/k&/n&m	】ㅖ〗
bE/k&/n&n	】ㅖふ
bE/k&/nE	】ㅖ〆
bE/k&/nES	】ㅖ㉳
bE/k&/ni	】ㅖこ
bE/k&/nim	】ㅖㄶ
bE/k&n	】㔩
bE/kE/S&m	】ㄢ㆑
bE/kE/S&n	】ㄢむ
bE/kE/SE	】ㄢㅠ
bE/kE/SE/Sun	】ㄢㅠ㆒
bE/kE/Si	】ㄢげ
bE/kE/Sim	】ㄢ㕥
bE/kE/Sin	】ㄢ゙
bE/kE/Sun	】ㄢ㆒
bE/kES	】㌐
bE/ka/rE	】㐶〕
bE/ko	】ぇ
bE/ko/n&m	】ぇ〗
bE/ko/nE	】ぇ〆
bE/ko/ni	】ぇこ
bE/kon	】け
bE/ku/bi	】㉗ち
bE/ku/bu/nE	】㉗ら〆
bE/kub	】䁴
bE/l&/x&/rE	】㌧㆖〕
bE/l&/x&/rE/ma/Sin	】㌧㆖〕〖゙
bE/ma/l&m	】〖ㆄ
bE/mal	】㔹
bE/mi/r&m	】〃㄄
bE/mi/rE	】〃〕
bE/mi/ri	】〃〵
bE/mu/n&m	】㉀〗
bE/mu/n&n	】㉀ふ
bE/mu/nE	】㉀〆
bE/mu/ni	】㉀こ
bE/mun	】だ
bE/nE/vi/s&m	】〆㒇㑷
bE/nE/vi/sE	】〆㒇〇
bE/nE/vi/si	】〆㒇々
bE/nE/vis	】〆䅓
bE/ni/vis	】こ䅓
bE/p&/r&/mES	】ㅆ㈀㊒
bE/p&/r&m	】ㅆ㄄
bE/p&/r&n	】ㅆへ
bE/p&/rE	】ㅆ〕
bE/p&/rE/b&d	】ㅆ〕㄂
bE/p&/ri	】ㅆ〵
bE/p&/rim	】ㅆㆅ
bE/p&/rin	】ㅆㅃ
bE/p&/z&/nES	】ㅆㄥ㉳
bE/p&/z&m	】ㅆ㑶
bE/p&/z&n	】ㅆ㊖
bE/p&/zE	】ㅆㄕ
bE/p&/zi	】ㅆㄵ
bE/p&/zi/nES	】ㅆㄵ㉳
bE/p&r	】㖐
bE/p&r/bE/p&r	】㖐】㖐
bE/p&r/paS	】㖐㕉
bE/pa	】〘
bE/pi/Sun	】ㄉ㆒
bE/por/s&m	】㉕㑷
bE/por/s&n/b&d	】㉕㐙㄂
bE/por/si	】㉕々
bE/por/sim	】㉕䍔
bE/por/sin	】㉕㔗
bE/pors	】㝩
bE/pu/S&m	】ゆ㆑
bE/pu/SE	】ゆㅠ
bE/pu/Si	】ゆげ
bE/pu/Sim/bi/ya	】ゆ㕥ちㄈ
bE/pu/Su/nE	】ゆ㐤〆
bE/puS	】䄐
bE/r&8/s&m	】㐠㑷
bE/r&8/sin	】㐠㔗
bE/r&8s	】㔆
bE/r&m	】㄄
bE/r&n	】へ
bE/rE	】〕
bE/rE/b&/cE	】〕〡で
bE/rE/ba/SE	】〕〱ㅠ
bE/rE/s&m	】〕㑷
bE/rE/s&m/to	】〕㑷〙
bE/rE/sE	】〕〇
bE/rE/si	】〕々
bE/rE/sim	】〕䍔
bE/rE/su/n&/mEt	】〕㐣ゔ㞗
bE/rE/su/n&m	】〕㐣〗
bE/rE/su/nE	】〕㐣〆
bE/rE/su/ni	】〕㐣こ
bE/rE/su/nim	】〕㐣ㄶ
bE/rE/sun	】〕㡄
bE/rE/zil	】〕䄰
bE/rES/tE/giS	】てつ䊀
bE/rES/tE/ha/So	】てつと〈
bE/rES/tu/kE	】てㅡㄢ
bE/rES/tu/ka	】てㅡ㐶
bE/rES/tu/ki	】てㅡ〥
bE/rES/tuk	】て䎇
bE/rEn/GE/mun	】㈩㌲だ
bE/rEn/GES	】㈩㔶
bE/rEnG	】䅄
bE/rEs	】㚕
bE/rEs/tu/ka	】㚕ㅡ㐶
bE/rEs/tuk	】㚕䎇
bE/ri	】〵
bE/ri/arE	】〵㈧
bE/ri/bo/do	】〵ぶ〰
bE/ri/fEkr	】〵う
bE/ri/yun	】〵䝖
bE/ri/z&m	】〵㑶
bE/ri/z&n	】〵㊖
bE/ri/zE	】〵ㄕ
bE/ri/zi	】〵ㄵ
bE/ri/zim	】〵㍓
bE/rim	】ㆅ
bE/rim/to	】ㆅ〙
bE/rim/v&/li	】ㆅ㈶も
bE/rin	】ㅃ
bE/rin/8&/na/di	】ㅃㄷ〸び
bE/riz	】ㅣ
bE/ro	】〹
bE/sES	】㐃
bE/sa/z&m	】㈆㑶
bE/sa/z&n	】㈆㊖
bE/sa/zE	】㈆ㄕ
bE/sa/zi	】㈆ㄵ
bE/sa/zim	】㈆㍓
bE/saz	】䔑
bE/si/ya/ran/kum	】々ㄈ㔁䐐
bE/si/yar	】々㆐
bE/sin	】㔗
bE/su/zE	】㐣ㄕ
bE/t&/miz	】ㄒ㈗
bE/t&/rE/kE	】ㄒ〕ㄢ
bE/t&/rE/ku/nES	】ㄒ〕㉗㉳
bE/t&/rE/ku/ni	】ㄒ〕㉗こ
bE/t&/rE/kun	】ㄒ〕㝅
bE/t&/ra/Si	】ㄒㅹげ
bE/t&/raS	】ㄒㄐ
bE/t&r/s&n	】〄㐙
bE/t&r/sE	】〄〇
bE/t&r/si	】〄々
bE/t&r/su/ni/mE/Sun	】〄㐣こㆂ㆒
bE/t&r/sun	】〄㡄
bE/tE/rE/ku/nE	】つ〕㉗〆
bE/tE/rE/ku/nES	】つ〕㉗㉳
bE/tE/rE/ku/ni	】つ〕㉗こ
bE/tE/rE/ku/nim	】つ〕㉗ㄶ
bE/ta/zE	】ゅㄕ
bE/tu/n&m	】ㅡ〗
bE/tu/n&n	】ㅡふ
bE/tu/nE	】ㅡ〆
bE/tu/ni	】ㅡこ
bE/tu/nim	】ㅡㄶ
bE/tu/nin	】ㅡㅵ
bE/x&/r&m	】㆖㄄
bE/x&/r&m/goft	】㆖㄄ㅷ
bE/x&/r&n	】㆖へ
bE/x&/rE	】㆖〕
bE/x&/ri	】㆖〵
bE/x&/rim	】㆖ㆅ
bE/x&/rin	】㆖ㅃ
bE/x&n/dE	】ぁあ
bE/x&nd	】㐅
bE/x&r	】㕃
bE/xa/b&m	】し㙢
bE/xa/b&m/b&d	】し㙢㄂
bE/xa/b&n	】し㕲
bE/xa/bE	】し】
bE/xa/bE/ha	】し】と
bE/xa/bi	】しち
bE/xa/bim	】し䀣
bE/xa/bu/nE	】しら〆
bE/xa/bun	】し㘗
bE/xa/d&z	】し䒖
bE/xa/im	】し䈇
bE/xa/in	】し。
bE/xa/r&m	】し㄄
bE/xa/rE	】し〕
bE/xa/run	】し㘐
bE/xab	】㑦
bE/xad	】え
bE/xam	】㎓
bE/xan	】ひ
bE/xay	】ㅙ
bE/xer	】㝂
bE/xo	】ぷ
bE/xo/r&m	】ぷ㄄
bE/xo/rE	】ぷ〕
bE/xo/ri	】ぷ〵
bE/xo/rin	】ぷㅃ
bE/xor	】さ
bE/xu/n&/mES	】㄃ゔ㊒
bE/xu/n&m	】㄃〗
bE/xu/n&n	】㄃ふ
bE/xu/nE	】㄃〆
bE/xu/nE/pat	】㄃〆㤂
bE/xu/nE/xun	】㄃〆め
bE/xu/nES	】㄃㉳
bE/xu/ni	】㄃こ
bE/xu/nim	】㄃ㄶ
bE/xu/sus	】㄃䀒
bE/xun	】め
bE/ya	】ㄈ
bE/ya/in	】ㄈ。
bE/ya/in/Ga/xa/lE	】ㄈ。〉しぅ
bE/ya/poS/t&m	】ㄈ㖉ㅨ
bE/ya/r&/tES	】ㄈ㈀㉩
bE/ya/r&m	】ㄈ㄄
bE/ya/rE	】ㄈ〕
bE/ya/ri	】ㄈ〵
bE/ya/rim	】ㄈㆅ
bE/yad	】㉆
bE/yam	】㉂
bE/yar	】㆐
bE/yof/t&n	】㉶㍔
bE/yof/tE	】㉶つ
bE/yof/tE/Ga/mE	】㉶つ〉ㆂ
bE/yof/ti	】㉶ㅔ
bE/z&/n&/mES	】ㄥゔ㊒
bE/z&/n&/ma/rE	】ㄥゔ〖〕
bE/z&/n&/tE/Sun	】ㄥゔつ㆒
bE/z&/n&m	】ㄥ〗
bE/z&/n&n	】ㄥふ
bE/z&/nE	】ㄥ〆
bE/z&/nE/Sun	】ㄥ〆㆒
bE/z&/nES	】ㄥ㉳
bE/z&/ni	】ㄥこ
bE/z&/ni/Sun	】ㄥこ㆒
bE/z&/ni/b&/lE	】ㄥこ〡ぅ
bE/z&/ni/f&r/8E	】ㄥこ㊔㊁
bE/z&/nim	】ㄥㄶ
bE/z&/nin	】ㄥㅵ
bE/z&/nin/Ga	】ㄥㅵ〉
bE/z&n	】㊖
bE/z&n/bE/z&n	】㊖】㊖
bE/z&n/cE/ra	】㊖でㅹ
bE/za	】㎇
bE/za/r&/mES	】㎇㈀㊒
bE/za/r&/mEt	】㎇㈀㞗
bE/za/r&m	】㎇㄄
bE/za/r&n	】㎇へ
bE/za/rE	】㎇〕
bE/za/rE/G&/va/bE	】㎇〕㆗ゃ】
bE/za/rE/Sun	】㎇〕㆒
bE/za/rES	】㎇て
bE/za/ri	】㎇〵
bE/za/ri/Sun	】㎇〵㆒
bE/za/ri/mES	】㎇〵㊒
bE/za/riS	】㎇㐢
bE/za/rid	】㎇䁆
bE/za/rim	】㎇ㆅ
bE/za/rin	】㎇ㅃ
bE/zar	】〠
bES/k&/nE	㌕ㅖ〆
bES/ku/ni	㌕㉗こ
bES/ma/rE/Sun	㌕〖〕㆒
bES/ma/ri	㌕〖〵
bES/mar	㌕㉧
bES/mo/r&m	㌕㈓㄄
bES/mor	㌕㌰
bES/n&/v&m	㌕ゔ㦙
bES/n&/vE	㌕ゔ㔈
bES/n&/vi	㌕ゔ㒇
bES/n&/vim	㌕ゔ䘂
bES/na/si	㌕〸々
bES/ram	㌕㒀
bEbin	䉩
bEbin&m	㠨
bEf&rmayid	䙡
bEf/rEs/t&m	㤃㚕ㅨ
bEf/rEs/t&n	㤃㚕㍔
bEf/rEs/ti	㤃㚕ㅔ
bEf/rEst	㤃䅑
bEf/ru/S&n	㤃ㄹむ
bEf/ru/SE	㤃ㄹㅠ
bEf/ru/Si	㤃ㄹげ
bEf/ru/Sin	㤃ㄹ゙
bEg/z&/rE	䈢ㄥ〕
bEg/z&/rim	䈢ㄥㆅ
bEg/z&/ru/n&n	䈢ㄥㄹふ
bEh/t&/rE	㈢ㄒ〕
bEh/t&/rE/ma/ma/ni	㈢ㄒ〕〖〖こ
bEh/t&/ri	㈢ㄒ〵
bEh/t&/rin	㈢ㄒㅃ
bEh/t&r	㈢〄
bEh/tEr	㈢㞀
bEh/za/do	㈢㎇〰
bEh/zad	㈢㦁
bEht	䤄
bEht&rE	䔵
bEn/dE	㑙あ
bEn/da/z&/nES	㑙〴ㄥ㉳
bEn/da/z&/tE/Sun	㑙〴ㄥつ㆒
bEn/da/z&/tEt	㑙〴ㄥ㕶
bEn/da/z&m	㑙〴㑶
bEn/da/z&n	㑙〴㊖
bEn/da/zE	㑙〴ㄕ
bEn/da/zES	㑙〴ㄧ
bEn/da/zi	㑙〴ㄵ
bEn/da/zi/mES	㑙〴ㄵ㊒
bEn/da/zim	㑙〴㍓
bEn/daz	㑙㑠
bEn/zin	㑙䖐
bErt	䦇
bEs/po/rE	㎕べ〕
bEs/po/rim	㎕べㆅ
bEt	㐥
bEtuim	䅐
bExer	䘔
ba	〱
ba/8E	〱㊁
ba/8E/So	〱㊁〈
ba/8E/bun	〱㊁㘗
ba/8E/v&hS	〱㊁䑣
ba/8E/y&S	〱㊁㌷
ba/8ES	〱㚗
ba/E	〱【
ba/E/sE	〱【〇
ba/Es	〱㈸
ba/S&m	〱㆑
ba/S&n	〱む
ba/SE	〱ㅠ
ba/SE/b&/dES	〱ㅠ〡㈴
ba/SE/i/me/lE	〱ㅠ〷㊆ぅ
ba/SE/un	〱ㅠ〣
ba/SE/x&r/c&n/gE	〱ㅠ㕃ㆁぴ
ba/SE/xob	〱ㅠ〶
ba/Si	〱げ
ba/Sim	〱㕥
ba/Sin	〱゙
ba/b&/tE	〱〡つ
ba/ba	〱〱
ba/ba/Gun	〱〱ㄔ
ba/ba/SEs/mE	〱〱㘸ㆂ
ba/ba/So	〱〱〈
ba/ba/Su/nE	〱〱㐤〆
ba/ba/Su/no	〱〱㐤ㆈ
ba/ba/Sun	〱〱㆒
ba/ba/b&/ra/So/ma/cE	〱〱〡ㅹ〈〖で
ba/ba/b&/ra/So/ma/va	〱〱〡ㅹ〈〖ゃ
ba/ba/bE/bin	〱〱】぀
ba/ba/ba	〱〱〱
ba/ba/bo/zor/gE	〱〱ぶ㌙ぴ
ba/ba/bo/zor/gE/So	〱〱ぶ㌙ぴ〈
ba/ba/bo/zor/gE/Sun	〱〱ぶ㌙ぴ㆒
ba/ba/bo/zor/gES	〱〱ぶ㌙㐔
ba/ba/bo/zor/gEt	〱〱ぶ㌙䉥
ba/ba/bo/zor/ga	〱〱ぶ㌙㍡
ba/ba/bo/zorg	〱〱ぶ㈈
ba/ba/bo/zorg/xob	〱〱ぶ㈈〶
ba/ba/hE	〱〱ご
ba/ba/ha	〱〱と
ba/ba/ha/mun	〱〱とだ
ba/ba/ha/rE	〱〱と〕
ba/ba/ha/yi	〱〱と㆕
ba/ba/i/r&m	〱〱〷㄄
ba/ba/ku	〱〱㉗
ba/ba/ma/ma/n&/Sun	〱〱〖〖ゔ㆒
ba/ba/nist	〱〱㈡
ba/ba/ro	〱〱〹
ba/ba/t&m	〱〱ㅨ
ba/ba/xob	〱〱〶
ba/ba/yE	〱〱〤
ba/ba/yi	〱〱㆕
ba/ba/yi/ro	〱〱㆕〹
ba/baS	〱㐓
ba/bab	〱㤥
ba/bam	〱㝠
ba/bast	〱㦓
ba/bat	〱㐡
ba/ca	〱ㅘ
ba/d&/rE	〱㄰〕
ba/d&m	〱ㅕ
ba/d&r	〱ㆉ
ba/dEm/Gun	〱䅳ㄔ
ba/dum	〱㔲
ba/h&m	〱〦
ba/hE/Sun	〱ご㆒
ba/hES	〱ㆇ
ba/hEt	〱㍐
ba/ha/Sun	〱と㆒
ba/ha/l&m	〱とㆄ
ba/ha/lE	〱とぅ
ba/ha/li	〱とも
ba/ha/li/yE	〱とも〤
ba/ha/mun	〱とだ
ba/ha/rE	〱と〕
ba/ha/tun	〱とㄖ
ba/haS	〱㉰
ba/haS/v&/li	〱㉰㈶も
ba/hal	〱㔔
ba/hal/t&r	〱㔔〄
ba/hat	〱㕂
ba/hu/SE	〱㌨ㅠ
ba/huS	〱䌧
ba/ka/la	〱㐶〢
ba/lE/SE	〱ぅㅠ
ba/lES	〱㈱
ba/lESt	〱㥳
ba/lEt	〱㆔
ba/la/cE	〱〢で
ba/la/f&/8&t	〱〢ㅂ㍴
ba/la/gor/bE/hE	〱〢㙱】ご
ba/la/nist	〱〢㈡
ba/la/s&/rE	〱〢づ〕
ba/la/s&/rE/Sun	〱〢づ〕㆒
ba/la/s&/rES	〱〢づて
ba/la/t&/rE	〱〢ㄒ〕
ba/la/t&r	〱〢〄
ba/la/v&/rE	〱〢㈶〕
ba/la/xob	〱〢〶
ba/la/yE	〱〢〤
ba/la/yE/&k/sE	〱〢〤ㄆ〇
ba/la/yi	〱〢㆕
ba/la/yi/yE	〱〢㆕〤
ba/la/yi/ya/ro	〱〢㆕ㄈ〹
ba/la/yiS	〱〢㞔
ba/laS	〱㜗
ba/lam	〱㎔
ba/last	〱㦔
ba/m&/su/li/y&/ti/yE	〱ば㐣も㍗ㅔ〤
ba/m&/z&st	〱ばㄙ
ba/m&/zE	〱ばㄕ
ba/m&/zE/h&st	〱ばㄕ㉙
ba/m&/zE/hE	〱ばㄕご
ba/m&/zE/yi	〱ばㄕ㆕
ba/m&/zES	〱ばㄧ
ba/rE	〱〕
ba/ra8/ba	〱㑒〱
ba/ran	〱㔁
ba/rat/bE	〱ㄦ】
ba/ri/k&/la	〱〵ㅖ〢
ba/ru/nE	〱ㄹ〆
ba/run	〱㘐
ba/s&/fa	〱づ㕈
ba/s&/nES	〱づ㉳
ba/s&/vad	〱づ䅒
ba/s&n/d&/li	〱㐙㄰も
ba/to	〱〙
ba/tup	〱㎐
ba/v&/fa	〱㈶㕈
ba/v&/r&m	〱㈶㄄
ba/v&/rEt	〱㈶㑣
ba/v&r	〱㍉
ba/x&/mir	〱㆖㑈
ba/xo/la/sE	〱ぷ〢〇
ba/y&/din	〱㍗㌒
ba/y&d	〱ㅦ
ba/y&d/cE/mis/vak	〱ㅦで㝱㡦
ba/y&d/do/ros/tE	〱ㅦ〰㉨つ
ba/yEst	〱䢂
ba/z&m	〱㑶
ba/zE	〱ㄕ
ba/zES	〱ㄧ
ba/zES/mEr/si	〱ㄧ㐘々
ba/za/rE	〱㎇〕
ba/zar	〱〠
ba/zi	〱ㄵ
ba/zi/&m	〱ㄵ〓
ba/zi/SE	〱ㄵㅠ
ba/zi/So	〱ㄵ〈
ba/zi/cE/ra	〱ㄵでㅹ
ba/zi/g&/rE	〱ㄵㄠ〕
ba/zi/g&/rES	〱ㄵㄠて
ba/zi/g&/ra	〱ㄵㄠㅹ
ba/zi/g&/ra/nE/tun	〱ㄵㄠㅹ〆ㄖ
ba/zi/g&/ri	〱ㄵㄠ〵
ba/zi/g&r	〱ㄵ㈥
ba/zi/guS	〱ㄵ㐷
ba/zi/ha	〱ㄵと
ba/zi/ha/mun	〱ㄵとだ
ba/zi/ha/yi	〱ㄵと㆕
ba/zi/hi	〱ㄵょ
ba/zi/r&f/tE	〱ㄵ㉃つ
ba/zi/to	〱ㄵ〙
ba/zi/tun	〱ㄵㄖ
ba/zi/xob	〱ㄵ〶
ba/zi/y&/ro	〱ㄵ㍗〹
ba/zi/yE	〱ㄵ〤
ba/zi/ya	〱ㄵㄈ
ba/zi/ya/tun	〱ㄵㄈㄖ
ba/zi/ya/yE	〱ㄵㄈ〤
ba/zi/ya/yi	〱ㄵㄈ㆕
ba/zi/yaS	〱ㄵ㐸
ba/zi/yat	〱ㄵ㥶
ba/zi/yi	〱ㄵ㆕
ba/zi/yi/yE	〱ㄵ㆕〤
ba/zi/yo	〱ㄵ㊕
ba/ziS	〱㕠
ba/zim	〱㍓
ba/zit	〱㤅
ba8/c&/tun	㖘㙈ㄖ
ba8/cE	㖘で
ba8/l&/va	㖘㌧ゃ
baS	㐓
baSE	䜓
baba	䑅
bad/ko/n&/kES	㑉ぇゔ㌐
bad/ko/n&k	㑉ぇ㑐
bad/ko/n&ko	㑉ぇ㑧
baf/tES	䄖㉩
bagz/ba/ni	㠠〱こ
bagz/ba/ni/E	㠠〱こ【
bagz/ba/niS	㠠〱㊇
bak/la	䅂〢
bak/tE/ri	䅂つ〵
bak/tE/ri/ya	䅂つ〵ㄈ
bak/tEri	䅂䜳
bal	㠗
bal/SE/k&s/tE	㠗ㅠ㡈つ
bal/ba/l&/kE/So	㠗〱㌧ㄢ〈
bal/da/rE	㠗〴〕
bam/z&/zE	㝠ㄥㄕ
bar/bi	䂕ち
bar/bi/yE	䂕ち〤
bar/bi/ya	䂕ちㄈ
bar/biS	䂕㙴
bar/bit	䂕䄧
bar/bu/sa	䂕ら㈆
bar/bu/sa/ro	䂕ら㈆〹
bar/bu/sam	䂕ら㡑
bar/da/r&m	䂕〴㄄
bar/dar	䂕㐑
bar/ha	䂕と
bar/k&/la/dox/t&/r&m	䂕ㅖ〢ㄑㄒ㄄
bar/k&/la/n&/ba/y&d	䂕ㅖ〢ゔ〱ㅦ
bart	䦘
barz	倀
bas/ram	㠥㒀
bas/ta	㠥ゅ
bat/ri	㐡〵
bat/ri/yE	㐡〵〤
bat/riS	㐡㐢
bat/rit	㐡㡱
bax/ti	䆓ㅔ
bay	㝧
bay/bay	㝧㝧
baz	㐉
baz/bani	㐉㠦
bazi	䄦
be	ㅲ
be/b&/rE	ㅲ〡〕
be/b&r	ㅲ㈤
be/bi	ㅲち
be/bi/lu/ni/tunz	ㅲちぢこ䀑
be/bi/yE	ㅲち〤
be/bi/ya	ㅲちㄈ
be/bit	ㅲ䄧
be/nE	ㅲ〆
be/nol/mE/l&/li	ㅲ䕢ㆂ㌧も
be/nol/mE/l&/ni	ㅲ䕢ㆂ㌧こ
ben	㝀
bi	ち
bi/&/d&b	ちㅀ䑤
bi/No	ち䈃
bi/ad	ちㅴ
bi/bo/xar	ちぶ䍹
bi/bu/E	ちら【
bi/ca/r&/ro	ちㅘ㈀〹
bi/ca/rE	ちㅘ〕
bi/d&/lil	ち㄰䘙
bi/d&r/bE	ちㆉ】
bi/da/r&m	ち〴㄄
bi/da/r&n	ち〴へ
bi/da/rE	ち〴〕
bi/da/rE/Sun	ち〴〕㆒
bi/da/ri	ち〴〵
bi/da/ri/yE	ち〴〵〤
bi/da/rim	ち〴ㆅ
bi/dad	ち㙄
bi/dar	ち㐑
bi/gir	ちㅱ
bi/h&/va	ちㄱゃ
bi/h&/va/s&m	ちㄱゃ㑷
bi/h&/ya	ちㄱㄈ
bi/h&/zi/nE/yi	ちㄱㄵ〆㆕
bi/ho/sE/lE/gi	ち㌱〇ぅん
bi/ka/ri	ち㐶〵
bi/l&/ro	ち㌧〹
bi/li/tE	ちもつ
bi/lit	ち㕨
bi/m&/ni	ちばこ
bi/m&/su/li/y&/ti/yE	ちば㐣も㍗ㅔ〤
bi/m&/su/li/y&t	ちば㐣も㉦
bi/m&/zE	ちばㄕ
bi/ma/rEs/tan	ち〖㚕㎖
bi/ma/ri	ち〖〵
bi/ma/ri/yE	ち〖〵〤
bi/n&n/dE/gan	ちふあ䚑
bi/nam	ち䄸
bi/ni	ちこ
bi/ni/t&m	ちこㅨ
bi/ni/to	ちこ〙
bi/ni/yE	ちこ〤
bi/nit	ち㡧
bi/p&/d&	ちㅆ㄰
bi/pa	ち〘
bi/rE	ち〕
bi/ru/nE	ちㄹ〆
bi/run	ち㘐
bi/run/ma/mi	ち㘐〖〃
bi/run/to	ち㘐〙
bi/sE/da	ち〇〴
bi/t&/ma	ちㄒ〖
bi/t&m	ちㅨ
bi/t&r/bi/y&t	ち〄ち㉦
bi/xi/ya/lE	ち㌢ㄈぅ
bi/xi/ya/lES	ち㌢ㄈ㈱
bi/xi/yal	ち㌢䔶
bi/xo/di	ちぷび
bi/yE	ち〤
bi/ya	ちㄈ
bi/ya/bu/nE	ちㄈら〆
bi/ya/bu/ni	ちㄈらこ
bi/ya/bu/ni/y&m	ちㄈらこ㥹
bi/ya/bu/ni/yE	ちㄈらこ〤
bi/ya/bun	ちㄈ㘗
bi/ya/id	ちㄈ䅉
bi/ya/im	ちㄈ䈇
bi/ya/in	ちㄈ。
bi/ya/r&/tEt	ちㄈ㈀㕶
bi/ya/r&m	ちㄈ㄄
bi/ya/r&n	ちㄈへ
bi/ya/rE	ちㄈ〕
bi/ya/rES	ちㄈて
bi/ya/ri	ちㄈ〵
bi/ya/ri/mES	ちㄈ〵㊒
bi/ya/riS	ちㄈ㐢
bi/ya/rim	ちㄈㆅ
bi/ya/rin	ちㄈㅃ
bi/ya/va/zE	ちㄈゃㄕ
bi/ya/vaz	ちㄈ㝵
bi/ya/yi	ちㄈ㆕
bi/yad	ち㉆
bi/yam	ち㉂
bi/yan	ち㍷
bi/yan/moS/t&/ri/tun	ち㍷㜅ㄒ〵ㄖ
bi/yar	ち㆐
bi/yay	ち㌡
bi/yof/t&m	ち㉶ㅨ
bi/yof/t&n	ち㉶㍔
bi/yof/tE	ち㉶つ
bi/yof/ti	ち㉶ㅔ
bi/yof/tim	ち㉶㐩
bi/yof/tin	ち㉶㌥
bi/yoft/tE/min/Gu/ri	ち䜃つ㉴㄀〵
bi/yum	ち䖙
bi/z&h/m&t	ち䍨㝡
biN	䑁
biS/t&/rE	㙴ㄒ〕
biS/t&/rE/So	㙴ㄒ〕〈
biS/t&/rE/Sun	㙴ㄒ〕㆒
biS/t&/rES	㙴ㄒて
biS/t&/ri	㙴ㄒ〵
biS/t&/ri/yE	㙴ㄒ〵〤
biS/t&r	㙴〄
biar	㢇
bis/ku/i/tE	㒓㉗〷つ
bis/ku/it	㒓㉗㒔
bis/tE	㒓つ
bis/ta	㒓ゅ
bis/ta/tun	㒓ゅㄖ
bis/ta/yi/yE	㒓ゅ㆕〤
bis/to/do/yE	㒓〙〰〤
bis/to/mE	㒓〙ㆂ
bis/tom	㒓㑲
bist	㍳
biya	㥵
biyar	䐹
bo/bo/zi/yE	ぶぶㄵ〤
bo/do	ぶ〰
bo/do/bo/do	ぶ〰ぶ〰
bo/do/xob	ぶ〰〶
bo/do/yi	ぶ〰㆕
bo/do/yim	ぶ〰䌦
bo/ko/S&m	ぶぇ㆑
bo/ko/S&n	ぶぇむ
bo/ko/SE	ぶぇㅠ
bo/ko/n&m	ぶぇ〗
bo/ko/n&n	ぶぇふ
bo/ko/nE	ぶぇ〆
bo/ko/nE/f&h/mi/di	ぶぇ〆㔤〃び
bo/ko/nE/gor/bE/yE	ぶぇ〆㙱】〤
bo/ko/ni	ぶぇこ
bo/ko/niS	ぶぇ㊇
bo/ko/nid	ぶぇ㙆
bo/ko/nim	ぶぇㄶ
bo/ko/nin	ぶぇㅵ
bo/kon	ぶけ
bo/l&n	ぶ㍕
bo/l&n/d&n	ぶ㍕ぱ
bo/l&n/dE	ぶ㍕あ
bo/l&n/dE/Sun	ぶ㍕あ㆒
bo/l&n/dES	ぶ㍕㈴
bo/l&n/da	ぶ㍕〴
bo/l&n/di	ぶ㍕び
bo/l&nd	ぶ㍥
bo/l&nd/gu	ぶ㍥〒
bo/l&nd/t&r	ぶ㍥〄
bo/l&nd/y&/ni	ぶ㍥㍗こ
bo/li/NES	ぶも㠢
bo/liN	ぶ㥸
bo/liN/E	ぶ㥸【
bo/liz	ぶ䝗
bo/lo/ka/yE	ぶ㌳㐶〤
bo/lu/zE/to	ぶぢㄕ〙
bo/lu/zES	ぶぢㄧ
bo/lu/zEt	ぶぢ㚄
bo/luz	ぶ䠳
bo/ri/d&/nES	ぶ〵㄰㉳
bo/ri/d&m	ぶ〵ㅕ
bo/ri/dE	ぶ〵あ
bo/ri/di	ぶ〵び
bo/ri/k&/lo	ぶ〵ㅖ㌳
bo/riN	ぶ㦐
bo/ro	ぶ〹
bo/ro/mi/nu	ぶ〹〃ㄳ
bo/ro/pE/d&r/tak	ぶ〹ㄣㆉ㠩
bo/roS/li	ぶ㥃も
bo/ros	ぶ㉨
bo/ruz/bir	ぶ㈐䄩
bo/xa/ri	ぶし〵
bo/xo/r&/mES	ぶぷ㈀㊒
bo/xo/r&/mEt	ぶぷ㈀㞗
bo/xo/r&/nES	ぶぷ㈀㉳
bo/xo/r&/nEt	ぶぷ㈀ㄲ
bo/xo/r&/tE/Sun	ぶぷ㈀つ㆒
bo/xo/r&m	ぶぷ㄄
bo/xo/r&n	ぶぷへ
bo/xo/rE	ぶぷ〕
bo/xo/rES	ぶぷて
bo/xo/rEm	ぶぷ䂆
bo/xo/ri	ぶぷ〵
bo/xo/riS	ぶぷ㐢
bo/xo/rim	ぶぷㆅ
bo/xo/rin	ぶぷㅃ
bo/xor	ぶさ
bo/z&m	ぶ㑶
bo/zE	ぶㄕ
bo/zE/yi	ぶㄕ㆕
bo/za	ぶ㎇
bo/zi	ぶㄵ
bo/zi/ya	ぶㄵㄈ
bo/zi/yi	ぶㄵ㆕
bo/zor/g&m	ぶ㌙㍑
bo/zor/g&n	ぶ㌙㙡
bo/zor/gE	ぶ㌙ぴ
bo/zor/gE/So	ぶ㌙ぴ〈
bo/zor/gES	ぶ㌙㐔
bo/zor/ga	ぶ㌙㍡
bo/zor/ga/r&m	ぶ㌙㍡㄄
bo/zor/ga/ro	ぶ㌙㍡〹
bo/zor/gast	ぶ㌙䐧
bo/zor/gi	ぶ㌙ん
bo/zor/gi/yE	ぶ㌙ん〤
bo/zorg	ぶ㈈
bo/zorg/t&/r&n	ぶ㈈ㄒへ
bo/zorg/t&/rE	ぶ㈈ㄒ〕
bo/zorg/t&/rE/S&m	ぶ㈈ㄒ〕㆑
bo/zorg/t&/rE/So	ぶ㈈ㄒ〕〈
bo/zorg/t&/rES	ぶ㈈ㄒて
bo/zorg/t&/ra	ぶ㈈ㄒㅹ
bo/zorg/t&r	ぶ㈈〄
boS/8a/bE	ㅄぃ】
boS/8a/bES	ㅄぃ㌕
boS/8a/bEt	ㅄぃ㐥
boS/8ab	ㅄㅅ
bok/nE	䤁〆
bol&nd	䠄
bol/bo/lE	㔷ぶぅ
bol/bol	㔷㔷
bom	䥘
bomb	㜦
bon/b&st	䍙㙖
bor/GEt	㐁㔐
bor/d&/mES	㐁㄰㊒
bor/d&m	㐁ㅕ
bor/d&n	㐁ぱ
bor/dE	㐁あ
bor/dES	㐁㈴
bor/di	㐁び
bor/diS	㐁㦕
bor/dim	㐁㈖
bor/din	㐁㌒
borG	䠂
bord	㈳
bord/cE	㈳で
bot/ri	䙂〵
bot/ri/yE	䙂〵〤
bot/z&/dE	䙂ㄥあ
boxor	䌶
boy	䤨
boz	㡘
boz/bad/ko/ni	㡘㑉ぇこ
boz/bo/zE	㡘ぶㄕ
boz/bo/zi	㡘ぶㄵ
boz/bo/zi/yE	㡘ぶㄵ〤
boz/bo/zi/ya/r&m	㡘ぶㄵㄈ㄄
br&/SIN	䅩䅰
bra	䦙
bros/li	䤩も
brus/li/yE	䥆も〤
bu	ら
bu/8E	ら㊁
bu/8i/yE	ら㌶〤
bu/d&/mEt	ら㄰㞗
bu/d&/nEt	ら㄰ㄲ
bu/d&/rE	ら㄰〕
bu/d&/tES	ら㄰㉩
bu/d&m	らㅕ
bu/d&n	らぱ
bu/d&nd	ら䔰
bu/dE	らあ
bu/dES	ら㈴
bu/di	らび
bu/di/mES	らび㊒
bu/diS	ら㦕
bu/dim	ら㈖
bu/din	ら㌒
bu/i	ら〷
bu/l&nd	ら㍥
bu/lup	ら䜩
bu/mEt	ら㞗
bu/ma/ran	ら〖㔁
bu/sE	ら〇
bu/sES	ら㐃
bu/sEt	らㅸ
bu/yE	ら〤
bu8	㡇
bud	㉄
bud/goft	㉄ㅷ
bud/sob	㉄㐨
bud/xob	㉄〶
buk	䉙
bur	䈀
bus	㐧
buz/m&/zE/yE	䜁ばㄕ〤
c&/NE	㙈㙗
c&/NES	㙈㠢
c&/Na/lE	㙈䐰ぅ
c&/Na/li	㙈䐰も
c&/Nal	㙈㠲
c&/Nu/l&m	㙈䜖ㆄ
c&/Nul	㙈䌆
c&/m&/nE	㙈ば〆
c&/m&/na	㙈ば〸
c&/mE/du/nE/SE	㙈ㆂㄩ〆ㅠ
c&/pE	㙈ㄣ
c&/pE/Sun	㙈ㄣ㆒
c&/pES	㙈䉁
c&N	䀨
c&S/mE	䍲ㆂ
c&Sm	ㅤ
c&k/mE	㘵ㆂ
c&k/mE/puS	㘵ㆂ䄐
c&k/mE/yE	㘵ㆂ〤
c&n/dE	ㆁあ
c&n/do/mE	ㆁ〰ㆂ
c&n/dom	ㆁ㤸
c&n/ga	ㆁ㍡
c&n/gal	ㆁ㚐
c&n/ha	ㆁと
c&n/ta	ㆁゅ
c&n/ta/dust	ㆁゅ〳
c&n/taS	ㆁ㐵
c&n/tast	ㆁ㍁
c&nd	㈅
c&p	䊑
c&r/mi	㈘〃
c&r/xES	㈘㌃
c&r/xa	㈘し
c&r/xi/d&n	㈘㌢ぱ
c&r/xi/dE	㈘㌢あ
c&r/xun/dES	㈘め㈴
c&rx	䅀
c&rx/k&r/dE	䅀㉲あ
c&s/ba	䄕〱
c&s/p&/mun	䄕ㅆだ
c&s/pE	䄕ㄣ
c&s/pE/Sun	䄕ㄣ㆒
c&s/pES	䄕䉁
c&s/pEt	䄕㥕
c&s/pi/dE	䄕ㄉあ
c&s/pi/di	䄕ㄉび
c&s/pun/dE	䄕䅷あ
c&s/pun/di	䄕䅷び
c&s/pun/diS	䄕䅷㦕
c&s/pun/dim	䄕䅷㈖
c&s/pund	䄕䈸
c&sb	䤉
c&sm	䎓
c&sp	䂃
c&tr	䔩
cE	で
cE/8&/dE	でㄷあ
cE/8&d	で㖓
cE/8&d/rE	で㖓〕
cE/8&d/rES	で㖓て
cE/8&dr	で㉡
cE/Gu/ri	で㄀〵
cE/Gu/ri/yE	で㄀〵〤
cE/Gur	で㥓
cE/S&/mE	で㍸ㆂ
cE/S&m	で㆑
cE/SE	でㅠ
cE/SE/So	でㅠ〈
cE/SE/to	でㅠ〙
cE/SES	で㎀
cE/SEk/li	で㆓も
cE/SEt	で㕁
cE/Sa	で〨
cE/Sa/SE	で〨ㅠ
cE/Sa/So	で〨〈
cE/Sa/to	で〨〙
cE/SaS	で㚙
cE/Sam	で㙲
cE/Sat	で㥘
cE/hEl	で䘕
cE/kES/ti	で㌐ㅔ
cE/ka/r&st	で㐶㞅
cE/ka/rES	で㐶て
cE/kar	で㈣
cE/lo/do	で㌳〰
cE/lun/dE	で䕉あ
cE/lun/di	で䕉び
cE/nin	でㅵ
cE/pa/to	で〘〙
cE/pi/dE	でㄉあ
cE/pi/di	でㄉび
cE/rE/lax	で〕䅃
cE/ra	でㅹ
cE/ra/8E	でㅹ㊁
cE/ra/8ES	でㅹ㚗
cE/ra/8a	でㅹぃ
cE/ra/dast/kE/Sat	でㅹ䅵ㄢ㥘
cE/ra/la/ki	でㅹ〢〥
cE/ra8	で㑒
cE/to	で〙
cE/to/rE	で〙〕
cE/to/ri	で〙〵
cE/to/ri/yE	で〙〵〤
cE/tor	で㉅
cE/va/i	でゃ〷
cE/xob	で〶
cES	㊉
cES/m&k	㊉㉷
cES/mE	㊉ㆂ
cES/mE/So	㊉ㆂ〈
cES/mE/yE	㊉ㆂ〤
cES/mES	㊉㊒
cES/ma/SE	㊉〖ㅠ
cES/ma/So	㊉〖〈
cES/ma/to	㊉〖〙
cES/ma/yE	㊉〖〤
cES/mat	㊉䈱
cESat	䈲
cESm	㔡
cEl	䆀
cEl/ta	䆀ゅ
cEr/ta	㞕ゅ
cEr/to/pEr/tE	㞕〙㞘つ
cEr/to/pErt	㞕〙㞖
cEra	䐳
cEra8	㘄
cEracE	䥤
cErk	㙥
ca/8u	ㅘ㖒
ca/do/rE	ㅘ〰〕
ca/do/rim	ㅘ〰ㆅ
ca/dor	ㅘ㘠
ca/hE	ㅘご
ca/ha/rE	ㅘと〕
ca/ha/rEt	ㅘと㑣
ca/ha/ro	ㅘと〹
ca/ha/rom	ㅘと䘣
ca/har	ㅘ㍃
ca/har/d&h	ㅘ㍃㉈
ca/har/ta	ㅘ㍃ゅ
ca/i	ㅘ〷
ca/i/So	ㅘ〷〈
ca/i/ha/ro	ㅘ〷と〹
ca/i/t&m	ㅘ〷ㅨ
ca/i/yE	ㅘ〷〤
ca/ma/dun	ㅘ〖㙣
ca/nom	ㅘ䌥
ca/r&m	ㅘ㄄
ca/rE	ㅘ〕
ca/rE/yi	ㅘ〕㆕
ca/rEt	ㅘ㑣
ca/rah	ㅘ㥅
ca/ro	ㅘ〹
ca/ro/mE	ㅘ〹ㆂ
ca/rom	ㅘ䘣
ca/xan	ㅘひ
ca/yi/ro	ㅘ㆕〹
ca8	㘇
cah	䝰
cai&m	㌄
can	䤂
car	㉇
car/S&n/bE	㉇む】
car/d&/ho/mE	㉇㄰㌱ㆂ
car/d&/hom	㉇㄰䒘
car/d&h	㉇㉈
car/d&h/sa/lE	㉇㉈㈆ぅ
car/d&st	㉇㎑
car/s&d	㉇㞄
car/sa/lE/yi	㉇㈆ぅ㆕
car/ta	㉇ゅ
car/taS	㉇㐵
car/tast	㉇㍁
car/zad	㉇㦁
cart	䤥
casb	䤈
ci	ぉ
ci/&m	ぉ〓
ci/&n	ぉㅐ
ci/SE	ぉㅠ
ci/So	ぉ〈
ci/Sun	ぉ㆒
ci/bE/hE/tun	ぉ】ごㄖ
ci/bi	ぉち
ci/ci	ぉぉ
ci/dE	ぉあ
ci/di	ぉび
ci/din	ぉ㌒
ci/kar	ぉ㈣
ci/n&/v&S	ぉゔ䅥
ci/ni	ぉこ
ci/ro	ぉ〹
ci/to	ぉ〙
ci/xo/dE	ぉぷあ
ci/y&n	ぉ䀸
ci/yE	ぉ〤
ci/yEn	ぉ䤢
ci/ya	ぉㄈ
ci/yan	ぉ㍷
ci/yo	ぉ㊕
ci/z&/ro	ぉㄥ〹
ci/zE	ぉㄕ
ci/zES	ぉㄧ
ci/za	ぉ㎇
ci/za/i	ぉ㎇〷
ci/za/ro	ぉ㎇〹
ci/za/t&m	ぉ㎇ㅨ
ci/za/yE	ぉ㎇〤
ci/za/yi	ぉ㎇㆕
ci/za/yi/yE	ぉ㎇㆕〤
ci/zat	ぉ㠱
ci/zi	ぉㄵ
ci/zi/E	ぉㄵ【
ci/zi/ro	ぉㄵ〹
ci/zi/yE	ぉㄵ〤
ci/zi/yi/rE	ぉㄵ㆕〕
ci/zi/yo	ぉㄵ㊕
ci/ziS	ぉ㕠
ci/zo	ぉ㝉
ciS	㔨
cips	㠑
cit	䡆
ciyE	䔤
ciz	ㅢ
ciz/ha	ㅢと
ciz/mi/za	ㅢ〃㎇
co/8o/li	㤉㖀も
co/ma8/da/rast	㤉䝹〴㈠
cod	䥇
con	㐀
con/kE	㐀ㄢ
cort	䒆
crai	䌓
cu/b&s/t&/ni	㌉㐐ㄒこ
cu/bE	㌉】
cu/bES	㌉㌕
cu/bEt	㌉㐥
cu/ba	㌉〱
cu/bi	㌉ち
cu/bi/yE	㌉ち〤
cu/iN	㌉䒉
cu/nE	㌉〆
cu/nE/yE	㌉〆〤
cub	䍡
cun	䍂
d&/8E	㄰㊁
d&/8i	㄰㌶
d&/8i/8&n	㄰㌶㚉
d&/8i/8&st	㄰㌶䅨
d&/8i/8E	㄰㌶㊁
d&/8i/8e/i	㄰㌶䆘〷
d&/8i/yE	㄰㌶〤
d&/8i8	㄰䐕
d&/bEs/tan	㄰㎕㎖
d&/d&	㄰㄰
d&/d&/ro	㄰㄰〹
d&/di/yE	㄰び〤
d&/fE	㄰㈷
d&/fE/ha/yE	㄰㈷と〤
d&/fE/yE	㄰㈷〤
d&/h&/n&m	㄰ㄱ〗
d&/h&/nE	㄰ㄱ〆
d&/h&/nE/So	㄰ㄱ〆〈
d&/h&/nE/Sun	㄰ㄱ〆㆒
d&/h&/nE/tE	㄰ㄱ〆つ
d&/h&/nE/to	㄰ㄱ〆〙
d&/h&/nES	㄰ㄱ㉳
d&/h&/nEt	㄰ㄱㄲ
d&/h&n	㄰㐈
d&/hE	㄰ご
d&/kE	㄰ㄢ
d&/kE/hE	㄰ㄢご
d&/li/li	㄰もも
d&/lil	㄰䘙
d&/m&r	㄰㚀
d&/mE	㄰ㆂ
d&/ma/8&m	㄰〖ㅶ
d&/ma/8E/So	㄰〖㊁〈
d&/ma/8E/to	㄰〖㊁〙
d&/ma/8ES	㄰〖㚗
d&/ma/8Et	㄰〖㚑
d&/rE	㄰〕
d&/rE/GE	㄰〕㌲
d&/rE/S&m	㄰〕㆑
d&/rE/So	㄰〕〈
d&/rES	㄰て
d&/ra/r&m	㄰ㅹ㄄
d&/ra/rE	㄰ㅹ〕
d&/rad	㄰㚇
d&/rar	㄰㔴
d&/ri/a/yE	㄰〵〧〤
d&/ri/a/yi	㄰〵〧㆕
d&/ri/a/yi/&m	㄰〵〧㆕〓
d&/ri/a/yi/yE	㄰〵〧㆕〤
d&/ri/mE/Sun	㄰〵ㆂ㆒
d&/ri/v&/ri	㄰〵㈶〵
d&/ri/ya	㄰〵ㄈ
d&/ri/ya/cE	㄰〵ㄈで
d&/ri/ya/ha	㄰〵ㄈと
d&/ri/ya/hast	㄰〵ㄈ㠁
d&/ri/ya/yi	㄰〵ㄈ㆕
d&/ri/ya/yi/yE	㄰〵ㄈ㆕〤
d&/ro	㄰〹
d&/v&/t&n	㄰㈶㍔
d&/v&/tE/Sun	㄰㈶つ㆒
d&/v&/tES	㄰㈶㉩
d&/v&t	㄰䉹
d&/va	㄰ゃ
d&/va/Su/n&m	㄰ゃ㐤〗
d&/va/Sun	㄰ゃ㆒
d&/va/mun	㄰ゃだ
d&/va/yE	㄰ゃ〤
d&/vam	㄰倄
d&/vat	㄰䆖
d&/vaz/d&	㄰㝵㄰
d&/vaz/d&/hE	㄰㝵㄰ご
d&/vaz/d&/ho/mE	㄰㝵㄰㌱ㆂ
d&/vaz/d&/hom	㄰㝵㄰䒘
d&/vaz/d&h	㄰㝵㉈
d&/vaz/d&h/m&n	㄰㝵㉈㄁
d&/vaz/d&h/ta	㄰㝵㉈ゅ
d&/vaz/d&st	㄰㝵㎑
d&/vid	㄰㘀
d&N	䌅
d&St	㖂
d&d	㘖
d&f/n&	㤧ゔ
d&f/t&/rE	㤧ㄒ〕
d&f/t&/rEt	㤧ㄒ㑣
d&f/t&r	㤧〄
d&f/t&r/cE	㤧〄で
d&f/t&r/cE/yE	㤧〄で〤
d&f/tE/rE/So	㤧つ〕〈
d&f/tEr	㤧㞀
d&h	㉈
d&h&ndEyE	䙄
d&h/ta	㉈ゅ
d&h/ta/dust	㉈ゅ〳
d&h/va/rE	㉈ゃ〕
d&hb&rab&rE	䑡
d&m	ㅕ
d&m/pa/yi	ㅕ〘㆕
d&m/pa/yi/to	ㅕ〘㆕〙
d&m/pa/yim	ㅕ〘䌦
d&m/pa/yit	ㅕ〘䂔
d&n/dan	ぱ䚖
d&n/do/n&t	ぱ〰㒁
d&n/du/n&/ro	ぱㄩゔ〹
d&n/du/n&m	ぱㄩ〗
d&n/du/nE	ぱㄩ〆
d&n/du/nE/Sun	ぱㄩ〆㆒
d&n/du/nE/Sun/a/h&/ni/E	ぱㄩ〆㆒〧ㄱこ【
d&n/du/nES	ぱㄩ㉳
d&n/du/na	ぱㄩ〸
d&n/du/na/So	ぱㄩ〸〈
d&n/du/na/Sun	ぱㄩ〸㆒
d&n/du/na/to	ぱㄩ〸〙
d&n/du/na/tun	ぱㄩ〸ㄖ
d&n/du/na/yE	ぱㄩ〸〤
d&n/du/naS	ぱㄩ㉒
d&n/du/nam	ぱㄩ䄸
d&n/du/nat	ぱㄩ㐆
d&n/dun	ぱ㙣
d&n/dun/mun	ぱ㙣だ
d&n/dun/pE/zE/Sk	ぱ㙣ㄣㄕ䘵
d&n/dun/tam	ぱ㙣㙹
d&n/tu/na/to	ぱㅡ〸〙
d&r	ㆉ
d&r/bE/d&/ra	ㆉ】㄰ㅹ
d&r/ba/y&d	ㆉ〱ㅦ
d&r/ba/z&st	ㆉ〱ㄙ
d&r/ba/z&t	ㆉ〱㡵
d&r/ba/zE	ㆉ〱ㄕ
d&r/ba/zE/yE	ㆉ〱ㄕ〤
d&r/bar	ㆉ䂕
d&r/cE	ㆉで
d&r/d&m	ㆉㅕ
d&r/dE	ㆉあ
d&r/dE/s&r/ha	ㆉあ㎙と
d&r/dES	ㆉ㈴
d&r/dEt	ㆉ㈃
d&r/di	ㆉび
d&r/s&/dES	ㆉづ㈴
d&r/s&d	ㆉ㞄
d&r/sE	ㆉ〇
d&r/sES	ㆉ㐃
d&r/va/zE/ban	ㆉゃㄕ䁕
d&r/vay	ㆉㅒ
d&r/xast	ㆉ䀧
d&r/ya	ㆉㄈ
d&r/ya/i	ㆉㄈ〷
d&r/ya/yi	ㆉㄈ㆕
d&r/ya/yi/ro	ㆉㄈ㆕〹
d&r/ya/yi/yE	ㆉㄈ㆕〤
d&r/ya/yi/yi	ㆉㄈ㆕㆕
d&r/ya/yi/yim	ㆉㄈ㆕䌦
d&r/yaS	ㆉ㐸
d&r/yast	ㆉ㑔
d&rd	ㄗ
d&rs	䉅
d&s/ma/go/zaSt	゗〖い㖔
d&s/mal	゗㔹
d&s/t&/mo	゗ㄒ㈓
d&s/t&/ro	゗ㄒ〹
d&s/t&S	゗㚖
d&s/t&m	゗ㅨ
d&s/tE	゗つ
d&s/tE/S&m	゗つ㆑
d&s/tE/SE	゗つㅠ
d&s/tE/So	゗つ〈
d&s/tE/Sun	゗つ㆒
d&s/tE/hE	゗つご
d&s/tE/ha/yE	゗つと〤
d&s/tE/mun	゗つだ
d&s/tE/tE	゗つつ
d&s/tE/to	゗つ〙
d&s/tE/tun	゗つㄖ
d&s/tE/yE	゗つ〤
d&s/tES	゗㉩
d&s/tEt	゗㕶
d&s/ta	゗ゅ
d&s/ta/So	゗ゅ〈
d&s/ta/mun	゗ゅだ
d&s/ta/to	゗ゅ〙
d&s/ta/yE	゗ゅ〤
d&s/taS	゗㐵
d&s/tam	゗㙹
d&s/tat	゗㤱
d&s/ti	゗ㅔ
d&s/to/pa/co/lof/ti	゗〙〘㤉䜕ㅔ
d&s/to/pa/co/lof/ti/y&/s&n	゗〙〘㤉䜕ㅔ㍗㐙
d&s/tu/rE	゗ㅡ〕
d&s/tu/ri	゗ㅡ〵
d&s/tur	゗䀰
d&st	㎑
d&st/b&n/dE/tE	㎑㕲あつ
d&st/b&nd	㎑㍆
d&st/ga/hE	㎑㍡ご
d&st/gir	㎑ㅱ
d&st/kE/SE	㎑ㄢㅠ
d&st/kES	㎑㌐
d&st/ma	㎑〖
d&st/ma/li	㎑〖も
d&st/mal	㎑㔹
d&st/moz/dES	㎑䍖㈴
d&st/mozd	㎑䔕
d&st/poxt	㎑䈂
d&st/rE/si	㎑〕々
d&stb&nd	䘰
dE	あ
dE/8&t	あ㍴
dE/8E	あ㊁
dE/8i/8&st	あ㌶䅨
dE/8i/8E	あ㌶㊁
dE/8i/8ES	あ㌶㚗
dE/8i/8e	あ㌶䆘
dE/dE/lES	ああ㈱
dE/fa	あ㕈
dE/gE	あぴ
dE/ha/nES	あと㉳
dE/l&/mE	あ㌧ㆂ
dE/l&m	あㆄ
dE/lE	あぅ
dE/lE/SE	あぅㅠ
dE/lE/So	あぅ〈
dE/lE/Sun	あぅ㆒
dE/lE/mun	あぅだ
dE/lES	あ㈱
dE/lES/b&d	あ㈱㄂
dE/lEt	あ㆔
dE/la/m&m	あ〢㍲
dE/la/v&/ri	あ〢㈶〵
dE/la/v&r	あ〢㍉
dE/ma/8E/to	あ〖㊁〙
dE/r&x/San	あ㉸㞙
dE/r&x/tE	あ㉸つ
dE/r&x/ta	あ㉸ゅ
dE/r&x/ta/Sun	あ㉸ゅ㆒
dE/r&x/ta/ro	あ㉸ゅ〹
dE/r&x/ta/yE	あ㉸ゅ〤
dE/r&x/taS	あ㉸㐵
dE/r&x/to	あ㉸〙
dE/r&xt	あ㊈
dE/ra/zE	あㅹㄕ
dE/ra/zi	あㅹㄵ
dE/rax	あ䉣
dE/raz	あ㙰
dE/sa	あ㈆
dE/ta/bE/to	あゅ】〙
dE/tab	あ㕄
dE/xa/l&t	あし㜥
dES	㈴
dEh/xo/da	䕶ぷ〴
dEl	㎁
dEl/p&/zir	㎁ㅆ䄇
dErazE	䙆
dEs/tE/so	倇つㅇ
da/8E	〴㊁
da/8u/nE	〴㖒〆
da/8u/nE/Sun	〴㖒〆㆒
da/8un	〴㉱
da/GEr	〴㜡
da/d&/nan/kum	〴㄰ㅑ䐐
da/d&m	〴ㅕ
da/d&n	〴ぱ
da/dE	〴あ
da/dES	〴㈴
da/da/S&m	〴〴㆑
da/da/SE	〴〴ㅠ
da/da/SES	〴〴㎀
da/da/SEt	〴〴㕁
da/da/Si	〴〴げ
da/da/Si/r&m	〴〴げ㄄
da/da/Si/ro	〴〴げ〹
da/da/Si/yE	〴〴げ〤
da/da/Si/yo	〴〴げ㊕
da/da/So	〴〴〈
da/da/bE/rE/ka/8&z	〴〴】〕㐶䆑
da/da/cE	〴〴で
da/da/sEt	〴〴ㅸ
da/daS	〴㈂
da/di	〴び
da/di/yE	〴び〤
da/did	〴㌦
da/dim	〴㈖
da/din	〴㌒
da/hE	〴ご
da/i	〴〷
da/kE	〴ㄢ
da/m&/nE	〴ば〆
da/m&/nE/tE	〴ば〆つ
da/m&/nE/to	〴ば〆〙
da/m&/nES	〴ば㉳
da/m&/nEt	〴ばㄲ
da/m&/ni	〴ばこ
da/m&n	〴㄁
da/m&n/dar	〴㄁㐑
da/mE	〴ㆂ
da/mad	〴䚔
da/man/to	〴〩〙
da/nES	〴㉳
da/nES/Gu	〴㉳㄀
da/nES/ga	〴㉳㍡
da/nES/ga/hE	〴㉳㍡ご
da/nES/gah	〴㉳㐗
da/nEl/dak	〴䈉䅙
da/na/nES	〴〸㉳
da/r&/mES	〴㈀㊒
da/r&m	〴㄄
da/r&n	〴へ
da/r&n/f&/8&t	〴へㅂ㍴
da/r&n/hi/ci	〴へょぉ
da/r&n/s&x/t&r	〴へ㌓〄
da/rE	〴〕
da/rE/ba/ba	〴〕〱〱
da/rE/cE	〴〕で
da/rE/di/gE	〴〕びぴ
da/ri	〴〵
da/ri/a/yE	〴〵〧〤
da/riS	〴㐢
da/rim	〴ㆅ
da/rin	〴ㅃ
da/ru	〴ㄹ
da/ru/8&m	〴ㄹㅶ
da/ru/8E	〴ㄹ㊁
da/ru/8E/yE	〴ㄹ㊁〤
da/ru/a/yE	〴ㄹ〧〤
da/ru/a/yi	〴ㄹ〧㆕
da/ru/aS	〴ㄹ㒈
da/sa/tEt	〴㈆㕶
da/sam	〴㡑
da/v&r	〴㍉
da/xE/lE	〴㈙ぅ
da/xE/li	〴㈙も
da/yE/rE/yE	〴〤〕〤
da/yi	〴㆕
da/yi/Sun	〴㆕㆒
da8	㡡
daS/t&m	㈂ㅨ
daS/t&n	㈂㍔
daS/t&n/E	㈂㍔【
daS/tE	㈂つ
daS/tES	㈂㉩
daS/ti	㈂ㅔ
daS/tim	㈂㐩
daS/tin	㈂㌥
daSt	㑑
daSt/ci	㑑ぉ
daSt/h&/s&/ni	㑑ㄱづこ
dadaSi	䥔
dak	䅙
dal	䀦
dal/dal/Si	䀦䀦げ
dan	䚖
dar	㐑
dar/ci/nE	㐑ぉ〆
daru8E	䝦
das	䄨
das/tE	䄨つ
das/ta/nE	䄨ゅ〆
das/ta/nE/So	䄨ゅ〆〈
das/ta/nES	䄨ゅ㉳
das/ta/nEt	䄨ゅㄲ
das/ta/na	䄨ゅ〸
das/ta/na/yE	䄨ゅ〸〤
das/ta/na/yi	䄨ゅ〸㆕
das/ta/naS	䄨ゅ㉒
das/ta/ni	䄨ゅこ
das/ta/no	䄨ゅㆈ
das/tan	䄨㎖
das/tan/ha	䄨㎖と
day/na	㢅〸
day/na/so/rE	㢅〸ㅇ〕
day/na/so/ra	㢅〸ㅇㅹ
day/na/so/ro	㢅〸ㅇ〹
day/na/sor	㢅〸㡀
day/na/sor/ha	㢅〸㡀と
day/no/sor/ha/ro	㢅ㆈ㡀と〹
de/yE	䎉〤
di	び
di/S&/bE	び㍸】
di/S&b	び㎂
di/d&/n&m	び㄰〗
di/d&/nE	び㄰〆
di/d&/nES	び㄰㉳
di/d&/nET	び㄰䜄
di/d&/tES	び㄰㉩
di/d&m	びㅕ
di/d&n	びぱ
di/dE	びあ
di/dE/sob	びあ㐨
di/dES	び㈴
di/da/rE/tun	び〴〕ㄖ
di/di/mE/Sun	びびㆂ㆒
di/di/mES	びび㊒
di/di/nES	びび㉳
di/diS	び㦕
di/dim	び㈖
di/din	び㌒
di/g&/ra/no	びㄠㅹㆈ
di/g&/ran	びㄠ㔁
di/g&/ro	びㄠ〹
di/g&/tun	びㄠㄖ
di/g&S	び㙨
di/g&n	び㙡
di/g&st	び㜙
di/gE	びぴ
di/gE/Sam	びぴ㙲
di/gE/ma/man/bo/zor/g&m	びぴ〖〩ぶ㌙㍑
di/gE/yE	びぴ〤
di/gE/yi	びぴ㆕
di/gE/yi/E	びぴ㆕【
di/gES	び㐔
di/rE	び〕
di/rEt	び㑣
di/ru/zES	びㄹㄧ
di/ruz	び㈐
di/vE	び㔈
di/vES	び㝨
di/va/n&m	びゃ〗
di/va/nE	びゃ〆
di/va/rE	びゃ〕
di/va/ra/rE	びゃㅹ〕
di/var	び㘕
di/vi/di	び㒇び
di/vi/di/yE	び㒇び〤
di/vist	び㥴
di/vo/dEl/b&r	び㖆㎁㈤
di/vu/nE	び㞐〆
di/yE/go	び〤い
diN	䑆
diS	㦕
did	㌦
didi	䔲
dig	㡤
dik	㜶
dik/ta/to/ri	㜶ゅ〙〵
dir	㡰
dir/t&r	㡰〄
dir/v&8t	㡰㑴
div	䍵
do	〰
do/&n	〰ㅐ
do/8o/lu	〰㖀ぢ
do/8o/lu/im	〰㖀ぢ䈇
do/8o/lu/yE	〰㖀ぢ〤
do/E	〰【
do/Ga	〰〉
do/S&k	〰㜨
do/Sax	〰㑤
do/ba/r&/ro	〰〱㈀〹
do/ba/rE	〰〱〕
do/c&r/x&/SE	〰㈘㆖ㅠ
do/c&r/x&S	〰㈘䠈
do/c&r/xE/s&/va/ri	〰㈘㈙づゃ〵
do/hE	〰ご
do/id	〰䅉
do/la	〰〢
do/m&m	〰㍲
do/mE	〰ㆂ
do/mE/SE	〰ㆂㅠ
do/mE/So	〰ㆂ〈
do/mES	〰㊒
do/mi	〰〃
do/n&/f&/ri	〰ゔㅂ〵
do/na	〰〸
do/r&S	〰㡢
do/rE	〰〕
do/rE/Sun	〰〕㆒
do/rE/g&rd	〰〕䅢
do/rES	〰て
do/ri	〰〵
do/ro	〰〹
do/ro/sot	〰〹䚀
do/roS/tE	〰㥃つ
do/roSt	〰㘨
do/ros	〰㉨
do/ros/t&/rE	〰㉨ㄒ〕
do/ros/tE	〰㉨つ
do/ros/tES	〰㉨㉩
do/ros/ti	〰㉨ㅔ
do/ros/ti/yE	〰㉨ㅔ〤
do/rost	〰ぐ
do/ru8	〰㠘
do/sE/ta	〰〇ゅ
do/ta	〰ゅ
do/ta/Sun	〰ゅ㆒
do/ta/mun	〰ゅだ
do/ta/r&m	〰ゅ㄄
do/ta/tun	〰ゅㄖ
do/ta/yi	〰ゅ㆕
do/ta/yi/tun	〰ゅ㆕ㄖ
do/ta/yi/yE	〰ゅ㆕〤
do/taS	〰㐵
do/tast	〰㍁
do/vo/mE	〰㖆ㆂ
do/vo/mE/S&m	〰㖆ㆂ㆑
do/vo/mi	〰㖆〃
do/vo/miS	〰㖆㍂
do/vo/min	〰㖆㉴
do/vom	〰䅁
doS	䁇
doS/m&/nE	䁇ば〆
doS/m&/nEt	䁇ばㄲ
doS/m&/ni	䁇ばこ
doS/m&n	䁇㄁
dobarE	䕗
dok/m&/ro	㕰ば〹
dok/m&S	㕰㍧
dok/mE	㕰ㆂ
dok/mE/ha	㕰ㆂと
dok/mE/ha/yE	㕰ㆂと〤
dok/mE/haS	㕰ㆂ㉰
dok/mE/yE	㕰ㆂ〤
dok/to/rE	㕰〙〕
dok/tor	㕰㉅
dol/fin	㔒㔓
dol/fin/E	㔒㔓【
dom	㤸
dom/bE	㤸】
dom/bE/So	㤸】〈
dom/ba/lE/Sun	㤸〱ぅ㆒
dom/ba/lES	㤸〱㈱
dom/dE/ra/zi	㤸あㅹㄵ
don/ba/lE	ㆃ〱ぅ
don/ba/lE/Sun	ㆃ〱ぅ㆒
don/ba/lE/tun	ㆃ〱ぅㄖ
don/ba/lES	ㆃ〱㈱
don/ba/lEt	ㆃ〱㆔
don/ya	ㆃㄈ
don/ya/yE	ㆃㄈ〤
don/yast	ㆃ㑔
dor	㘠
dotaro	䤤
dox/t&/r&/ro	ㄑㄒ㈀〹
dox/t&/r&m	ㄑㄒ㄄
dox/t&/r&n	ㄑㄒへ
dox/t&/rE	ㄑㄒ〕
dox/t&/rE/Sun	ㄑㄒ〕㆒
dox/t&/ra	ㄑㄒㅹ
dox/t&/ra/yE	ㄑㄒㅹ〤
dox/t&/ran	ㄑㄒ㔁
dox/t&/ri	ㄑㄒ〵
dox/t&/ri/ya	ㄑㄒ〵ㄈ
dox/t&/ru/nE	ㄑㄒㄹ〆
dox/t&r	ㄑ〄
doz	㕆
doz/d&/ro	㕆㄰〹
doz/dE	㕆あ
doz/da/nE	㕆〴〆
doz/da/yE	㕆〴〤
doz/di	㕆び
doz/di/t&/tES	㕆びㄒ㉩
dozd	䌙
dozd/ha/yE	䌙と〤
dr&/gEn/ba/lE	㥉㥐〱ぅ
dr&/gEn/bal	㥉㥐㠗
dr&/gon/ba/lE	㥉㔵〱ぅ
du/8&m	ㄩㅶ
du/8E	ㄩ㊁
du/8a	ㄩぃ
du/8a/yE	ㄩぃ〤
du/8i	ㄩ㌶
du/SE	ㄩㅠ
du/SEt	ㄩ㕁
du/Su	ㄩ㐤
du/du	ㄩㄩ
du/du/ra	ㄩㄩㅹ
du/n&/S&m	ㄩゔ㆑
du/n&/So	ㄩゔ〈
du/n&/Sun	ㄩゔ㆒
du/n&S	ㄩ㔸
du/n&st	ㄩ䂄
du/nE	ㄩ〆
du/nE/&/ro	ㄩ〆ㅀ〹
du/nE/a	ㄩ〆〧
du/nE/a/han	ㄩ〆〧ㅉ
du/nE/yi/&m	ㄩ〆㆕〓
du/rE	ㄩ〕
du/ra	ㄩㅹ
du/ru/8u	ㄩㄹ㖒
du/s&m	ㄩ㑷
du/sE/tun	ㄩ〇ㄖ
du/sES	ㄩ㐃
du/sEt	ㄩㅸ
du8	䌣
duS	䚃
dud	㕳
dud/kE/SE/SE	㕳ㄢㅠㅠ
dud/kE/SES	㕳ㄢ㎀
dul	㢒
dun/du/ni	㙣ㄩこ
dun/dun	㙣㙣
dur	㘘
dur/bi/nE	㘘ち〆
dur/bi/no	㘘ちㆈ
dur/bin	㘘぀
dur/ha/ta	㘘とゅ
dur/t&r	㘘〄
dus	㜑
dus/t&m	㜑ㅨ
dus/t&n	㜑㍔
dus/tE	㜑つ
dus/tE/SE	㜑つㅠ
dus/tE/Sin	㜑づ
dus/tE/tE	㜑つつ
dus/tES	㜑㉩
dus/tEt	㜑㕶
dus/ta	㜑ゅ
dus/ta/SE	㜑ゅㅠ
dus/ta/Sun	㜑ゅ㆒
dus/ta/mu/n&m	㜑ゅ㉀〗
dus/ta/mun	㜑ゅだ
dus/ta/nEt	㜑ゅㄲ
dus/ta/tun	㜑ゅㄖ
dus/ta/yE	㜑ゅ〤
dus/ta/yi	㜑ゅ㆕
dus/taS	㜑㐵
dus/tam	㜑㙹
dus/tan	㜑㎖
dus/tat	㜑㤱
dus/ti	㜑ㅔ
dus/tin	㜑㌥
dust	〳
dust/goft	〳ㅷ
dust/vay	〳ㅒ
e	ゑ
e/dE	ゑあ
e/n&/k&m	ゑゔ㉘
e/n&/kE	ゑゔㄢ
e/n&/kES	ゑゔ㌐
e/n&/ki	ゑゔ〥
e/n&k	ゑ㑐
e/nE	ゑ〆
e/v&/la	ゑ㈶〢
e/vay	ゑㅒ
e/vun	ゑ䙃
eb	㍠
ed	㦃
eh	㕔
f&/8&/tE	ㅂㄷつ
f&/8&d	ㅂ㖓
f&/8&t	ㅂ㍴
f&/da	ㅂ〴
f&/da/yE	ㅂ〴〤
f&/dat	ㅂ㚃
f&/kE/mun	ㅂㄢだ
f&/kES	ㅂ㌐
f&/kEt	ㅂ㊑
f&/l&/kE	ㅂ㌧ㄢ
f&/l&k	ㅂ㔑
f&/mi/dE	ㅂ〃あ
f&/mi/di	ㅂ〃び
f&/ra/muS	ㅂㅹ㑗
f&/ra/ra/han	ㅂㅹㅹㅉ
f&/ra/ri	ㅂㅹ〵
f&/ra/van	ㅂㅹ㥗
f&/ran/s&/vi/ya	ㅂ㔁づ㒇ㄈ
f&/ran/s&st	ㅂ㔁㠇
f&/ran/sE	ㅂ㔁〇
f&/ran/sE/yi	ㅂ㔁〇㆕
f&/rar	ㅂ㔴
f&/raz	ㅂ㙰
f&/ri/dE	ㅂ〵あ
f&/ri/dES	ㅂ〵㈴
f&/za/yE	ㅂ㎇〤
f&/za/yi/yE	ㅂ㎇㆕〤
f&8&t	䌷
f&h/mi/d&m	㔤〃ㅕ
f&h/mi/d&n	㔤〃ぱ
f&h/mi/dE	㔤〃あ
f&h/mi/di	㔤〃び
f&h/mi/din	㔤〃㌒
f&h/mid	㔤㔥
f&ks	䡲
f&l/s&/f&S	䍉づ䀁
f&n/do/8i	㔀〰㌶
f&r/8E	㊔㊁
f&r/8i	㊔㌶
f&r/da	㊔〴
f&r/da/yE	㊔〴〤
f&r/daS	㊔㈂
f&r/h&n/gE	㊔㐈ぴ
f&r/mun	㊔だ
f&r/na/mE	㊔〸ㆂ
f&r/v&r/din	㊔㍉㌒
f&r/yad	㊔㉆
f&r/z&n/da/nE	㊔㊖〴〆
f&r8	㜘
f&rS	㤄
f&s/la	ゕ〢
f&sl/ha	䙑と
f&sl/hast	䙑㠁
fE/Sa/rES	㈷〨て
fE/Sar	㈷㜐
fE/dE/rE/rE	㈷あ〕〕
fE/dE/rEr	㈷あ䀥
fE/l&n	㈷㍕
fE/lE/za	㈷ぅ㎇
fE/lE/zi/yE	㈷ぅㄵ〤
fE/lEz	㈷䐢
fE/rE/ni/yE	㈷〕こ〤
fE/rES/tE	㈷てつ
fE/rES/tE/ha	㈷てつと
fE/rES/tE/yE	㈷てつ〤
fE/rES/tE/yi	㈷てつ㆕
fE/rEs/ta/d&m	㈷㚕ゅㅕ
fE/rEs/ta/dE	㈷㚕ゅあ
fE/rEs/ta/di	㈷㚕ゅび
fE/ri/zEr	㈷〵㔧
fE/sEn/Gun	㈷䄤ㄔ
fES/8E/li	㘶㊁も
fES/fE/S&/ro	㘶㈷㍸〹
fES/fE/SE	㘶㈷ㅠ
fES/fE/SE/yE	㘶㈷ㅠ〤
fEk/r&m	㌑㄄
fEk/rE	㌑〕
fEk/rE/Sun	㌑〕㆒
fEk/rES	㌑て
fEk/rEt	㌑㑣
fEk/ra	㌑ㅹ
fEk/ri	㌑〵
fEkr	う
fEkr/n&	うゔ
fEl/fE/lE	䁦㈷ぅ
fEl/fE/li	䁦㈷も
fEl/fE/li/yE	䁦㈷も〤
fEl/fEl	䁦䁦
fEn/Gun	䙱ㄔ
fEr	䉦
fEr/di/n&n/dE	䉦びふあ
fEr/di/n&nd	䉦び䐒
fEr/do/si	䉦〰々
fEr/fE/ri/yE	䉦㈷〵〤
fErfEri	䌈
fEs/tE/rE	䀔つ〕
fa	㕈
fa/E/zE	㕈【ㄕ
fa/i/dE	㕈〷あ
fa/i/dE/yi	㕈〷あ㆕
fa/mi/lE	㕈〃ぅ
fa/mi/lES	㕈〃㈱
fa/mi/la/Sun	㕈〃〢㆒
fa/mi/li/yE	㕈〃も〤
fa/mi/liS	㕈〃䀘
fa/mi/lit	㕈〃㕨
fa/sE/lE	㕈〇ぅ
fa/sE/le/E	㕈〇㑢【
fa/sE/le/i	㕈〇㑢〷
fa/sEd	㕈䍸
fa/t&/mE	㕈ㄒㆂ
fa/tE	㕈つ
fa/tE/mE	㕈つㆂ
fa/ti	㕈ㅔ
fa/yE/zE	㕈〤ㄕ
fa/zE/la/bE	㕈ㄕ〢】
fa/zE/lab	㕈ㄕ䂈
fa8/ti	䈡ㅔ
far/si	䉠々
far/si/yE	䉠々〤
far/sit	䉠㠵
fars	䐆
fay/dE	㍰あ
fe/rEnd	䝴䝵
fi/SaS	㉥㚙
fi/fa	㉥㕈
fi/l&m	㉥ㆄ
fi/lE	㉥ぅ
fi/la	㉥〢
fi/nE	㉥〆
fi/na/lES	㉥〸㈱
fi/na/la	㉥〸〢
fi/nal	㉥㤡
fi/niS	㉥㊇
fi/ri/zEr	㉥〵㔧
fi/ru/ze/i/E	㉥ㄹ䉉〷【
fi/ruz	㉥㈐
fi/ti/lE	㉥ㅔぅ
fi/yo/na	㉥㊕〸
fi/yu/zES	㉥㜀ㄧ
fi/yuz	㉥䁙
fi/zi/ki	㉥ㄵ〥
fil	㐖
fil/m&/ro	㐖ば〹
fil/mE	㐖ㆂ
fil/mE/So	㐖ㆂ〈
fil/mES	㐖㊒
fil/mEt	㐖㞗
fil/ma/yE	㐖〖〤
fil/mi	㐖〃
film	㥥
film/na/meE	㥥〸䡡
film/sa/zE	㥥㈆ㄕ
film/sa/za	㥥㈆㎇
film/sa/zi	㥥㈆ㄵ
fin	㔓
fl&S	䈖
fo/8ES	㎆㚗
fo/la/nE	㎆〢〆
fo/lan	㎆㍒
fo/lu/kE	㎆ぢㄢ
fo/ri	㎆〵
fo/ru	㎆ㄹ
fo/ru/S&n/dE	㎆ㄹむあ
fo/ru/S&n/dE/ha/yE	㎆ㄹむあと〤
fo/ru/S&n/de/E	㎆ㄹむ䎉【
fo/ruS	㎆ㅰ
fo/ruS/ga	㎆ㅰ㍡
fo/ruS/ga/hE	㎆ㅰ㍡ご
fo/ruS/gat	㎆ㅰ䐁
fo/rux/tim	㎆䑕㐩
fo/ruxt	㎆䔢
fo8ES&m	䑂
for/s&t	㝳㞂
foruSE	䘶
foruSa	䐤
foruSi	䘉
foruSiyE	䐀
fot	㥩
fu/tE/Sun	䀄つ㆒
fut	㑂
fut/ES	㑂㑃
fut/ba/l&m	㑂〱ㆄ
fut/ba/lE	㑂〱ぅ
fut/ba/lES	㑂〱㈱
fut/ba/lis/ta	㑂〱㢀ゅ
fut/bal	㑂㠗
g&/cE	ㄠで
g&/la/viz	ㄠ〢䌹
g&/lu	ㄠぢ
g&/luS	ㄠ㔄
g&/lum	ㄠㄡ
g&/lut	ㄠ㦒
g&/v&zn	ㄠ㝈
g&S/t&m	㙨ㅨ
g&S/t&n	㙨㍔
g&S/tE	㙨つ
g&S/ti	㙨ㅔ
g&S/tim	㙨㐩
g&St	䀂
g&bl	䥲
g&c	㤖
g&n/G&n	㙡㙳
g&n/Ga/yE	㙡〉〤
g&n/Ga/yi	㙡〉㆕
g&n/Gi/n&m	㙡㌆〗
g&n/Gi/nE/yE	㙡㌆〆〤
g&n/Go	㙡㒗
g&n/di	㙡び
g&n/do/mE	㙡〰ㆂ
g&n/do/mi	㙡〰〃
g&n/dom	㙡㤸
g&nG	䌴
g&r/d&/n&m	㈥㄰〗
g&r/d&/nE	㈥㄰〆
g&r/d&/nE/SE	㈥㄰〆ㅠ
g&r/d&/nE/Sun	㈥㄰〆㆒
g&r/d&/nE/mun	㈥㄰〆だ
g&r/d&/nES	㈥㄰㉳
g&r/d&/nEt	㈥㄰ㄲ
g&r/d&/no	㈥㄰ㆈ
g&r/d&m	㈥ㅕ
g&r/d&n	㈥ぱ
g&r/d&n/b&nd	㈥ぱ㍆
g&r/dE	㈥あ
g&r/dE/Si	㈥あげ
g&r/dES	㈥㈴
g&r/di	㈥び
g&r/din	㈥㌒
g&r/du/n&n	㈥ㄩふ
g&r/du/nE	㈥ㄩ〆
g&r/du/nim	㈥ㄩㄶ
g&r/dun	㈥㙣
g&r/dun/di	㈥㙣び
g&r/mE	㈥ㆂ
g&r/mE/tE	㈥ㆂつ
g&r/mES	㈥㊒
g&r/ma	㈥〖
g&r/mi	㈥〃
g&rm	㤗
gE/la	ぴ〢
gE/la/lud	ぴ〢䂉
gE/la/sE	ぴ〢〇
gE/li	ぴも
gE/li/Sun	ぴも㆒
gE/li/ma/li	ぴも〖も
gE/liS	ぴ䀘
gE/rE/hi	ぴ〕ょ
gE/rEf/t&/mES	ぴ㌤ㄒ㊒
gE/rEf/t&/mEt	ぴ㌤ㄒ㞗
gE/rEf/t&/nE	ぴ㌤ㄒ〆
gE/rEf/t&m	ぴ㌤ㅨ
gE/rEf/t&n	ぴ㌤㍔
gE/rEf/tE	ぴ㌤つ
gE/rEf/tEm	ぴ㌤㊐
gE/rEf/ta/rE	ぴ㌤ゅ〕
gE/rEf/ta/ri	ぴ㌤ゅ〵
gE/rEf/ta/ri/yE	ぴ㌤ゅ〵〤
gE/rEf/ti	ぴ㌤ㅔ
gE/rEf/ti/ro	ぴ㌤ㅔ〹
gE/rEf/tiS	ぴ㌤㝶
gE/rEf/tid	ぴ㌤䔄
gE/rEf/tim	ぴ㌤㐩
gE/rEf/tin	ぴ㌤㌥
gE/rEft	ぴ㚁
gE/ra/fist	ぴㅹ䕩
gE/ri/yE	ぴ〵〤
gE/rim	ぴㆅ
gE/riz	ぴㅣ
gE/ru/nE	ぴㄹ〆
gE/rum	ぴ䂀
gE/run	ぴ㘐
gE/run/t&r	ぴ㘐〄
gES	㐔
gESt	䔈
gEl	㝦
gEr/dE	㘓あ
gEr/da/lu/aS	㘓〴ぢ㒈
gEr/du	㘓ㄩ
gEr/du/a	㘓ㄩ〧
gEr/du/a/yE	㘓ㄩ〧〤
gEr/du/yE	㘓ㄩ〤
gEr/yE	㘓〤
gErf/t&m	䢗ㅨ
gErf/ti	䢗ㅔ
gErft	䤳
ga/hi	㍡ょ
ga/mE/no	㍡ㆂㆈ
ga/vE	㍡㔈
ga/zE	㍡ㄕ
ga/zES	㍡ㄧ
gar/da/no	㢗〴ㆈ
gar/fild	㢗㢘
gav	䄑
gaz	䁲
ge/E	䜤【
gi/GE	ん㌲
gi/gE	んぴ
gi/gES	ん㐔
gi/la/sa	ん〢㈆
gi/las	ん㔢
gi/r&/ro	ん㈀〹
gi/rE/hE	ん〕ご
gi/rE/yE	ん〕〤
gi/rE/yi/yE	ん〕㆕〤
gi/rES	んて
gi/re	ん㚅
gi/ya/nE	んㄈ〆
gi/yah/xar	ん䍕䍹
giG	䊗
gim/nas	ㆆ䄣
gir	ㅱ
gir/dar	ㅱ㐑
gir/to	ㅱ〙
go	い
go/GE/f&/r&n/gi	い㌲ㅂへん
go/l&m	いㆄ
go/lE	いぅ
go/la	い〢
go/la/yE	い〢〤
go/la/yi	い〢㆕
go/laS	い㜗
go/li	いも
go/li/yE	いも〤
go/lo	い㌳
go/lu/lE	いぢぅ
go/mES	い㊒
go/na	い〸
go/ri/lE	い〵ぅ
go/ri/lEt	い〵㆔
go/ri/la	い〵〢
go/ril	い䙳
go/ros/n&/SE	い㉨ゔㅠ
go/ros/n&/mE	い㉨ゔㆂ
go/ros/n&/ro	い㉨ゔ〹
go/ros/n&/tE	い㉨ゔつ
go/ros/n&st	い㉨䂄
go/ros/n&t	い㉨㒁
go/ros/nE	い㉨〆
go/ros/ne/gi	い㉨㤐ん
go/ros/ne/i	い㉨㤐〷
go/ru/hE	いㄹご
go/ruh	い䕲
go/tE	いつ
go/z&S/tE	いㅓつ
go/z&S/ti	いㅓㅔ
go/z&St	い㙕
go/za/r&m	い㎇㄄
go/za/reE	い㎇䜅
go/zaS/t&/mES	いっㄒ㊒
go/zaS/t&m	いっㅨ
go/zaS/t&n	いっ㍔
go/zaS/tE	いっつ
go/zaS/tE/GorG	いっつ䍣
go/zaS/tiS	いっ㝶
go/zaS/tim	いっ㐩
go/zaS/tin	いっ㌥
go/zaSt	い㖔
go/zar	い〠
goS/n&/SE	㍹ゔㅠ
goS/n&/mE	㍹ゔㆂ
goS/n&/tE	㍹ゔつ
goS/n&S	㍹㔸
goS/n&m	㍹〗
gof/t&/nES	ㅳㄒ㉳
gof/t&/nEt	ㅳㄒㄲ
gof/t&m	ㅳㅨ
gof/t&n	ㅳ㍔
gof/tE	ㅳつ
gof/tE/Sun	ㅳつ㆒
gof/tES	ㅳ㉩
gof/ti	ㅳㅔ
gof/tim	ㅳ㐩
gof/tin	ㅳ㌥
goft	ㅷ
goft&m	䜈
goft&n	䒇
goft/ba/baS	ㅷ〱㐓
goft/ci	ㅷぉ
goftES	䤗
gol	㔱
gol/b&r/gE	㔱㈤ぴ
gol/dun	㔱㙣
gol/gol	㔱㔱
gom	㕧
gom/b&/dE	㕧〡あ
gom/b&d	㕧㄂
gon/GES/ka	㔵㔶㐶
gon/GiSk	㔵䀓
gon/bol	㔵㔷
gon/d&m	㔵ㅕ
gon/dE	㔵あ
gon/dE/gi	㔵あん
gon/dE/h&/ro	㔵あㄱ〹
gon/dE/hE	㔵あご
gon/dE/t&r	㔵あ〄
gon/dE/yi	㔵あ㆕
gon/de/E	㔵䎉【
gor/b&/ro	㙱〡〹
gor/b&S	㙱㤀
gor/b&m	㙱㙢
gor/b&st	㙱㙖
gor/bE	㙱】
gor/bE/du/ni	㙱】ㄩこ
gor/bE/h&/r&m	㙱】ㄱ㄄
gor/bE/h&/ro	㙱】ㄱ〹
gor/bE/h&m	㙱】〦
gor/bE/h&st	㙱】㉙
gor/bE/hE	㙱】ご
gor/bE/ha	㙱】と
gor/bE/ha/yE	㙱】と〤
gor/bE/id	㙱】䅉
gor/ba	㙱〱
gor/be/E	㙱ㅲ【
gor/be/i	㙱ㅲ〷
gor/be/id	㙱ㅲ䅉
gor/g&/ro	㙱ㄠ〹
gor/g&m	㙱㍑
gor/g&st	㙱㜙
gor/gE	㙱ぴ
gor/ga	㙱㍡
gor/gan	㙱䚑
gor/ge/i	㙱䜤〷
gorb	䤇
gorbEyE	䔂
gorg	㘱
gozaSti	䈶
gu/Gi/gu/Gi	〒㌆〒㌆
gu/S&/m&m	〒㍸㍲
gu/S&m	〒㆑
gu/SE	〒ㅠ
gu/SE/S&m	〒ㅠ㆑
gu/SE/So	〒ㅠ〈
gu/SE/mun	〒ㅠだ
gu/SES	〒㎀
gu/SEt	〒㕁
gu/Sa/SE	〒〨ㅠ
gu/Sa/tu/no	〒〨ㅡㆈ
gu/Sa/yE	〒〨〤
gu/SaS	〒㚙
gu/Sam	〒㙲
gu/SeE	〒䑖
gu/Si	〒げ
gu/Si/Sun	〒げ㆒
gu/Si/yE	〒げ〤
gu/SiS	〒㈒
gu/gu/li	〒〒も
gu/gul	〒㠃
gu/gul/gu/lu	〒㠃〒ぢ
gu/l&m	〒ㆄ
gu/lE	〒ぅ
gu/lES	〒㈱
gu/lEt	〒㆔
gu/li/gu/li	〒も〒も
gu/ril	〒䙳
gu/sa/lE	〒㈆ぅ
guS	㐷
guS/gir	㐷ㅱ
guS/tE	㐷つ
guS/tE/So	㐷つ〈
guS/ta	㐷ゅ
guS/ta/So	㐷ゅ〈
guS/ta/tun	㐷ゅㄖ
guS/ti	㐷ㅔ
guSt	䔓
guSt/xar	䔓䍹
gul	㠃
gul/gu/l&/ka	㠃〒㌧㐶
gul/gu/l&/ka/yE	㠃〒㌧㐶〤
gul/gul	㠃㠃
gump	䝘
gus/f&nd	䦄䖃
gust	倆
h&/8E	ㄱ㊁
h&/8E/SE	ㄱ㊁ㅠ
h&/8E/tE	ㄱ㊁つ
h&/bi/bi	ㄱちち
h&/d&/fE	ㄱ㄰㈷
h&/d&/fES	ㄱ㄰㘶
h&/d&f	ㄱ㤧
h&/dE	ㄱあ
h&/di	ㄱび
h&/di/yE	ㄱび〤
h&/di/yE/yE	ㄱび〤〤
h&/f&l/h&S	ㄱ䍉㈑
h&/l&/zun	ㄱ㌧㙂
h&/lE	ㄱぅ
h&/lE/hu/lE	ㄱぅ㌨ぅ
h&/lES	ㄱ㈱
h&/li	ㄱも
h&/lo/win	ㄱ㌳䈵
h&/lu/ya/i	ㄱぢㄈ〷
h&/m&/SE	ㄱばㅠ
h&/m&/So	ㄱば〈
h&/m&/Su/no	ㄱば㐤ㆈ
h&/m&/Sun	ㄱば㆒
h&/m&/mun	ㄱばだ
h&/m&/ro	ㄱば〹
h&/m&/tun	ㄱばㄖ
h&/m&S	ㄱ㍧
h&/m&n	ㄱ㄁
h&/mE	ㄱㆂ
h&/mE/Ga	ㄱㆂ〉
h&/mE/Ga/yE	ㄱㆂ〉〤
h&/mE/GaS	ㄱㆂ㊂
h&/mE/ci	ㄱㆂぉ
h&/mE/ci/to	ㄱㆂぉ〙
h&/mE/ci/yE	ㄱㆂぉ〤
h&/mE/ciz	ㄱㆂㅢ
h&/mE/gi	ㄱㆂん
h&/mE/yE	ㄱㆂ〤
h&/mES	ㄱ㊒
h&/ma/rE	ㄱ〖〕
h&/mam	ㄱ㥖
h&/man/kum	ㄱ〩䐐
h&/mi/SE	ㄱ〃ㅠ
h&/mi/nE	ㄱ〃〆
h&/mi/nE/mun	ㄱ〃〆だ
h&/mi/na	ㄱ〃〸
h&/mi/no	ㄱ〃ㆈ
h&/mid	ㄱ㔥
h&/min	ㄱ㉴
h&/min/Ga	ㄱ㉴〉
h&/min/Ga/hast	ㄱ㉴〉㠁
h&/min/Ga/yi	ㄱ㉴〉㆕
h&/min/GaS	ㄱ㉴㊂
h&/min/Gast	ㄱ㉴㉵
h&/min/Gu/ri	ㄱ㉴㄀〵
h&/min/Gu/ri/yE	ㄱ㉴㄀〵〤
h&/min/Gu/riS	ㄱ㉴㄀㐢
h&/min/Gur	ㄱ㉴㥓
h&/min/kar	ㄱ㉴㈣
h&/min/to/rE	ㄱ㉴〙〕
h&/min/to/ri	ㄱ㉴〙〵
h&/min/tor	ㄱ㉴㉅
h&/mo	ㄱ㈓
h&/mu/ja/yi	ㄱ㉀㖈㆕
h&/mu/mE	ㄱ㉀ㆂ
h&/mu/ma	ㄱ㉀〖
h&/mu/mi	ㄱ㉀〃
h&/mu/mo	ㄱ㉀㈓
h&/mu/n&m	ㄱ㉀〗
h&/mu/nE	ㄱ㉀〆
h&/mu/na	ㄱ㉀〸
h&/mu/na/ro	ㄱ㉀〸〹
h&/mu/na/yi	ㄱ㉀〸㆕
h&/mu/ni	ㄱ㉀こ
h&/mu/no	ㄱ㉀ㆈ
h&/mum	ㄱ㌣
h&/mun	ㄱだ
h&/mun/8&dr	ㄱだ㉡
h&/mun/Ga	ㄱだ〉
h&/mun/Ga/hast	ㄱだ〉㠁
h&/mun/Ga/yi	ㄱだ〉㆕
h&/mun/Gast	ㄱだ㉵
h&/mun/Gu/ri	ㄱだ㄀〵
h&/mun/to/rE	ㄱだ〙〕
h&/na	ㄱ〸
h&/na/r&m	ㄱ〸㄄
h&/na/ro	ㄱ〸〹
h&/ni	ㄱこ
h&/nif/ho/sen	ㄱ䡔㌱䍧
h&/nu/z&m	ㄱㄳ㑶
h&/nuz	ㄱ㉓
h&/p&st	ㄱ䜣
h&/pE	ㄱㄣ
h&/pE/yE	ㄱㄣ〤
h&/rE/k&/t&m	ㄱ〕ㅖㅨ
h&/rE/k&/tE	ㄱ〕ㅖつ
h&/rE/k&/tEt	ㄱ〕ㅖ㕶
h&/rE/k&/ti	ㄱ〕ㅖㅔ
h&/rE/k&t	ㄱ〕㍢
h&/ri	ㄱ〵
h&/ri/f&/m&n	ㄱ〵ㅂ㄁
h&/ri/f&/mE	ㄱ〵ㅂㆂ
h&/ri/f&/mo	ㄱ〵ㅂ㈓
h&/ri/f&m	ㄱ〵㙓
h&/ri/fE	ㄱ〵㈷
h&/ri/fE/tE	ㄱ〵㈷つ
h&/ri/fEt	ㄱ〵䀱
h&/ri/fam	ㄱ〵㜷
h&/ri/pa/tEr	ㄱ〵〘㞀
h&/rif	ㄱ㘔
h&/s&/nE	ㄱづ〆
h&/s&/ni	ㄱづこ
h&/s&/ni/yE	ㄱづこ〤
h&/s&/ni/yo	ㄱづこ㊕
h&/s&n	ㄱ㐙
h&/sa/sE	ㄱ㈆〇
h&/sas	ㄱ䆔
h&/si/ri/yE	ㄱ々〵〤
h&/ta	ㄱゅ
h&/v&/sE/to	ㄱ㈶〇〙
h&/v&s	ㄱ䍷
h&/va	ㄱゃ
h&/va/i	ㄱゃ〷
h&/va/pe/ma	ㄱゃ㈁〖
h&/va/s&m	ㄱゃ㑷
h&/va/sE	ㄱゃ〇
h&/va/sE/Sun	ㄱゃ〇㆒
h&/va/sE/mun	ㄱゃ〇だ
h&/va/sE/tun	ㄱゃ〇ㄖ
h&/va/sES	ㄱゃ㐃
h&/va/sEt	ㄱゃㅸ
h&/va/yE	ㄱゃ〤
h&/var	ㄱ㘕
h&/vas	ㄱ䍑
h&/vast	ㄱ䄂
h&/vi/GE	ㄱ㒇㌲
h&/vi/GES	ㄱ㒇㔶
h&/vi/GaS	ㄱ㒇㊂
h&/viG	ㄱ䁶
h&/y&/Ga/ni	ㄱ㍗〉こ
h&/y&/Gan	ㄱ㍗㍅
h&/ya/tE	ㄱㄈつ
h&/ya/tE/Sun	ㄱㄈつ㆒
h&/ya/tE/tun	ㄱㄈつㄖ
h&/ya/ti	ㄱㄈㅔ
h&/yat	ㄱ㥶
h&/yu/la	ㄱ㜀〢
h&/yu/la/yE	ㄱ㜀〢〤
h&/yu/la/yi/yE	ㄱ㜀〢㆕〤
h&/yu/last	ㄱ㜀㦔
h&8	䙈
h&S/tE	㈑つ
h&S/tE/So	㈑つ〈
h&S/tES	㈑㉩
h&S/ta	㈑ゅ
h&S/ta/do	㈑ゅ〰
h&S/tad	㈑㊘
h&S/tad/ta	㈑㊘ゅ
h&S/ti/yE	㈑ㅔ〤
h&S/to	㈑〙
h&S/to/mE	㈑〙ㆂ
h&St	㞃
h&St/s&d	㞃㞄
h&b/sE	䎒〇
h&d/sE	䙨〇
h&ds	䝒
h&f/tE	㔂つ
h&f/tE/yE	㔂つ〤
h&f/tE/yi	㔂つ㆕
h&f/ta	㔂ゅ
h&f/ta/do	㔂ゅ〰
h&f/tad	㔂㊘
h&f/tad/ta	㔂㊘ゅ
h&f/tom	㔂㑲
h&ft	㔇
h&ft/s&d	㔇㞄
h&l	䑰
h&l/8&/ro	䑰ㄷ〹
h&l/8E/hE	䑰㊁ご
h&l/8E/yE	䑰㊁〤
h&l/8E/yi/yE	䑰㊁㆕〤
h&m	〦
h&m/8&/dE	〦ㄷあ
h&m/GEn/sE	〦䉱〇
h&m/GEn/sES	〦䉱㐃
h&m/S&h/ri	〦㖗〵
h&m/bE/f&r/ma/id	〦】㊔〖䅉
h&m/bEr/gEr	〦䔐㘓
h&m/cin	〦䉃
h&m/di/g&/ro	〦びㄠ〹
h&m/di/gE	〦びぴ
h&m/do/rE	〦〰〕
h&m/ka/r&m	〦㐶㄄
h&m/ka/rE	〦㐶〕
h&m/ka/rES	〦㐶て
h&m/ka/rEt	〦㐶㑣
h&m/lE	〦ぅ
h&m/lE/yE	〦ぅ〤
h&m/li/li/ya	〦ももㄈ
h&m/n&	〦ゔ
h&m/n&/gof/ti	〦ゔㅳㅔ
h&m/no	〦ㆈ
h&m/ra	〦ㅹ
h&m/ra/hE/mun	〦ㅹごだ
h&m/ra/mE	〦ㅹㆂ
h&m/raS	〦ㄐ
h&m/ram	〦㒀
h&m/ro	〦〹
h&m/s&/rE	〦づ〕
h&m/sE/nE	〦〇〆
h&m/sa/y&/Sun	〦㈆㍗㆒
h&m/sa/y&/mu/no	〦㈆㍗㉀ㆈ
h&m/sa/yE	〦㈆〤
h&m/sa/yE/hE	〦㈆〤ご
h&m/sa/yE/ha	〦㈆〤と
h&m/sa/yE/ha/tun	〦㈆〤とㄖ
h&m/sa/yE/hast	〦㈆〤㠁
h&m/sa/yE/yi	〦㈆〤㆕
h&m/xu/bE	〦㄃】
h&m/z&/bu/ni	〦ㄥらこ
h&ms/tEr	䁱㞀
h&mun	䘤
h&n	㐈
h&r	㈄
h&r/Ga	㈄〉
h&r/Ga/yi	㈄〉㆕
h&r/Gu/ri	㈄㄀〵
h&r/cE/8&dr	㈄で㉡
h&r/ci	㈄ぉ
h&r/ci/zi	㈄ぉㄵ
h&r/do/Sun	㈄〰㆒
h&r/do/ta/S&m	㈄〰ゅ㆑
h&r/do/ta/Sun	㈄〰ゅ㆒
h&r/do/ta/mun	㈄〰ゅだ
h&r/do/taS	㈄〰㐵
h&r/do/tu/nE	㈄〰ㅡ〆
h&r/do/tun	㈄〰ㄖ
h&r/do/yE	㈄〰〤
h&r/f&m	㈄㙓
h&r/fE	㈄㈷
h&r/fE/Sun	㈄㈷㆒
h&r/fE/in/Ga	㈄㈷。〉
h&r/fE/mun	㈄㈷だ
h&r/fES	㈄㘶
h&r/fEt	㈄䀱
h&r/fa	㈄㕈
h&r/fa/Sun	㈄㕈㆒
h&r/fa/to	㈄㕈〙
h&r/fa/yE	㈄㕈〤
h&r/fa/yi	㈄㕈㆕
h&r/fa/yi/yE	㈄㕈㆕〤
h&r/fat	㈄䉇
h&r/fi	㈄㉥
h&r/fi/Sun	㈄㉥㆒
h&r/fi/yE	㈄㉥〤
h&r/fo	㈄㎆
h&r/k&/si	㈄ㅖ々
h&r/kE/si	㈄ㄢ々
h&r/ki	㈄〥
h&r/v&8t	㈄㑴
h&rf	㊅
h&rf/b&d	㊅㄂
h&rf/ha/yE	㊅と〤
h&rfayE	䚇
h&s/t&/m&/zEt	㍵ㄒば㚄
h&s/t&m	㍵ㅨ
h&s/t&n	㍵㍔
h&s/tE	㍵つ
h&s/tE/ha/So	㍵つと〈
h&s/tE/yE	㍵つ〤
h&s/tES	㍵㉩
h&s/ti	㍵ㅔ
h&s/tid	㍵䔄
h&s/tim	㍵㐩
h&s/tin	㍵㌥
h&st	㉙
h&t/m&/ni	㝢ばこ
h&t/m&n	㝢㄁
h&ts	䘆
h&zm	䜲
hE	ご
hE/di/yE	ごび〤
hE/lE	ごぅ
hE/li/kup/tE/rE	ごも䊓つ〕
hE/li/kup/tEr	ごも䊓㞀
hE/lo	ご㌳
hE/sE	ご〇
hE/sa/b&m	ご㈆㙢
hE/sa/bE	ご㈆】
hE/sa/bES	ご㈆㌕
hE/sa/bi	ご㈆ち
hE/sab	ご䁤
hE/sab/kE/ta/bE	ご䁤ㄢゅ】
hE/sar/ta	ご㘆ゅ
hE/va/na/ti	ごゃ〸ㅔ
hE/zar	ご〠
hE/zar/ta	ご〠ゅ
hE/zar/ta/yi/yE	ご〠ゅ㆕〤
hEf/tE	䜙つ
hElp	䥖
hEn/du/nE	㞉ㄩ〆
hEn/du/nE/hE	㞉ㄩ〆ご
hEnd	㙵
hEt	㍐
hEv/sE	䁥〇
hEv/si	䁥々
hEvs	䉕
hEz/bE	䐦】
ha	と
ha/Gi	と㌆
ha/bi	とち
ha/bi/bird	とち䦈
ha/da/da/Si	と〴〴げ
ha/fE/zE	と㈷ㄕ
ha/fE/zE/m&n/d&m	と㈷ㄕ㄁ㅕ
ha/guS	と㐷
ha/ha/ha	ととと
ha/l&m	とㆄ
ha/lE	とぅ
ha/lE/Sun	とぅ㆒
ha/lE/tun	とぅㄖ
ha/lES	と㈱
ha/lEt	と㆔
ha/la	と〢
ha/la/v&8/ti	と〢㉣ㅔ
ha/li	とも
ha/liS	と䀘
ha/lim	と䜰
ha/lo/win	と㌳䈵
ha/mE/dE	とㆂあ
ha/mE/ro	とㆂ〹
ha/mE/yE	とㆂ〤
ha/mEd	と䑇
ha/man	と〩
ha/pu	とゆ
ha/pu/E	とゆ【
ha/pu/ha	とゆと
ha/pu/i	とゆ〷
ha/ru	とㄹ
ha/to	と〙
ha/va/pE/ya/ma	とゃㄣㄈ〖
ha/zE/r&m	とㄕ㄄
ha/zE/r&n	とㄕへ
ha/zE/rE	とㄕ〕
ha/zEr	と㔧
haG	㡔
hal	㔔
hala	䌠
han	ㅉ
har	㍃
har/di	㍃び
harf	䤓
hay	㘰
haz	䤧
he	㌠
he/k&/l&m	㌠ㅖㆄ
he/k&/lES	㌠ㅖ㈱
he/k&l	㌠䠔
he/mi/nu	㌠〃ㄳ
he/si/y&/tE	㌠々㍗つ
he/va/ni	㌠ゃこ
he/vu/n&m	㌠㞐〗
he/vu/na	㌠㞐〸
he/vu/na/yE	㌠㞐〸〤
he/vun	㌠䙃
hef	㙤
hi/ci	ょぉ
hi/cim	ょ䕥
hi/cis	ょ㜰
hiG/d&h	䈳㉈
hiG/d&h/ta	䈳㉈ゅ
hiS/kar	㡣㈣
hiS/ki	㡣〥
hic	㕑
hic/Ga	㕑〉
hic/Gu/ri	㕑㄀〵
hic/k&s	㕑㡈
hic/ki	㕑〥
hic/ko/du/mES	㕑ぇㄩ㊒
hic/ko/dum	㕑ぇ㔲
hic/v&8t	㕑㑴
hil/ton	䕡㠔
hiv/d&/hE	䅶㄰ご
hiv/d&/ho/mE	䅶㄰㌱ㆂ
hiv/d&/hom	䅶㄰䒘
hiv/d&h	䅶㉈
hm	㒒
ho	㌱
ho/8u/8E	㌱㖒㊁
ho/8u/8i	㌱㖒㌶
ho/8u8	㌱䔖
ho/bab	㌱㤥
ho/du/dE	㌱ㄩあ
ho/lE	㌱ぅ
ho/lES	㌱㈱
ho/lo/pi	㌱㌳ㄉ
ho/lu	㌱ぢ
ho/n&r/pi/S&/ro	㌱㑆ㄉ㍸〹
ho/n&r/pi/SE/h&/ro	㌱㑆ㄉㅠㄱ〹
ho/n&r/pi/Se/E	㌱㑆ㄉ㘷【
ho/ru/fE	㌱ㄹ㈷
ho/ruf	㌱㔦
ho/sE	㌱〇
ho/sE/l&/So	㌱〇㌧〈
ho/sE/l&S	㌱〇㝓
ho/sE/l&m	㌱〇ㆄ
ho/sE/l&t	㌱〇㜥
ho/sE/le/E	㌱〇㑢【
ho/se/ni	㌱㒑こ
ho/se/ni/yan	㌱㒑こ㍷
ho/sen	㌱䍧
ho/tE/lE	㌱つぅ
ho/tEl	㌱䕙
ho/tEl/ha/yE	㌱䕙と〤
ho/zE	㌱ㄕ
hol	㔠
hol/ba/y&d	㔠〱ㅦ
hosen	䡓
hu/S&N	㌨ㄸ
hu/lE/hu/pE	㌨ぅ㌨ㄣ
hu/lE/hup	㌨ぅ䜇
hu/la/hup	㌨〢䜇
hu/lu	㌨ぢ
hu/lu/yi/E	㌨ぢ㆕【
hu/luS	㌨㔄
hu/lut	㌨㦒
hu/ra	㌨ㅹ
hum	䥒
i	〷
i/Gad	〷䑠
i/Sun	〷㆒
i/d&t	〷ゐ
i/ko/n&m	〷ぇ〗
i/mE/li	〷ㆂも
i/mE/ni/yE	〷ㆂこ〤
i/n&m	〷〗
i/nE	〷〆
i/nES	〷㉳
i/na	〷〸
i/na/ha	〷〸と
i/na/haS	〷〸㉰
i/na/mo	〷〸㈓
i/na/r&m	〷〸㄄
i/na/rE	〷〸〕
i/na/ro	〷〸〹
i/na/yi	〷〸㆕
i/naG	〷䦗
i/nam	〷䄸
i/nast	〷䄁
i/ni	〷こ
i/no	〷ㆈ
i/ra/nE	〷ㅹ〆
i/ra/ni	〷ㅹこ
i/ra/ni/ya	〷ㅹこㄈ
i/ra/ni/ya/to	〷ㅹこㄈ〙
i/ra/niS	〷ㅹ㊇
i/ran	〷㔁
i/ta/li/ya/yi/E	〷ゅもㄈ㆕【
imun	䍄
in	。
in/G&m	。㍈
in/Ga	。〉
in/Ga/SE	。〉ㅠ
in/Ga/So	。〉〈
in/Ga/can/ta/dus	。〉䤂ゅ㜑
in/Ga/ce/ra	。〉䥢ㅹ
in/Ga/goft	。〉ㅷ
in/Ga/ha	。〉と
in/Ga/ha/ro	。〉と〹
in/Ga/haS	。〉㉰
in/Ga/hast	。〉㠁
in/Ga/kar/g&r/dan	。〉㈣㈥䚖
in/Ga/na	。〉〸
in/Ga/nist	。〉㈡
in/Ga/ro	。〉〹
in/Ga/xub	。〉㎗
in/Ga/yE	。〉〤
in/Ga/ya	。〉ㄈ
in/GaS	。㊂
in/Gam	。䀈
in/Gan	。㍅
in/Gast	。㉵
in/Gat	。㠀
in/Gu/ri	。㄀〵
in/Gu/ri/bE	。㄀〵】
in/Gu/ri/goft	。㄀〵ㅷ
in/Gu/ri/he	。㄀〵㌠
in/Gu/ri/ra/din	。㄀〵ㅹ㌒
in/Gu/ri/yE	。㄀〵〤
in/Gu/riS	。㄀㐢
in/Gur	。㥓
in/Sa/la	。〨〢
in/dor	。㘠
in/gi/li/s&n	。んも㐙
in/gi/li/sE	。んも〇
in/gi/li/si	。んも々
in/gi/li/si/&n	。んも々ㅐ
in/gi/li/si/yE	。んも々〤
in/gi/lis	。ん㢀
in/gof/t&m	。ㅳㅨ
in/ha/la	。と〢
in/haS	。㉰
in/kE	。ㄢ
in/ka/ha	。㐶と
in/kar	。㈣
in/ko/nE	。ぇ〆
in/ma/lE	。〖ぅ
in/ru	。ㄹ
in/to/li	。〙も
in/to/rE	。〙〕
in/to/ri	。〙〵
in/to/ri/yE	。〙〵〤
in/tor	。㉅
in/tu	。ㅡ
in/v&/r&m	。㈶㄄
in/v&/rE	。㈶〕
in/v&/rES	。㈶て
in/v&/ran/kum	。㈶㔁䐐
in/v&/ri	。㈶〵
in/v&/ri/yE	。㈶〵〤
in/v&/riS	。㈶㐢
in/v&r	。㍉
in/v&r/t&r	。㍉〄
in/xe/li	。ゖも
in/yE/ki	。〤〥
in/yE/ki/yE	。〤〥〤
inGa	䞔
inGaha	䝣
inGuri	㥲
intori	䥣
is	や
is/lam	や㎔
is/t&/kE	やㄒㄢ
is/t&k	や㘹
is/ta	やゅ
k&/ba/bE	ㅖ〱】
k&/ba/ba/So	ㅖ〱〱〈
k&/ba/ba/ro	ㅖ〱〱〹
k&/ba/bi	ㅖ〱ち
k&/bab	ㅖ㤥
k&/bu/t&/rE	ㅖらㄒ〕
k&/bu/t&r	ㅖら〄
k&/bud	ㅖ㉄
k&/c&l	ㅖ㤦
k&/fE	ㅖ㈷
k&/fE/yE	ㅖ㈷〤
k&/fES	ㅖ㘶
k&/fal	ㅖ䙖
k&/l&/SE	ㅖ㌧ㅠ
k&/l&/kE	ㅖ㌧ㄢ
k&/l&/kES	ㅖ㌧㌐
k&/l&/ka	ㅖ㌧㐶
k&/l&/kat	ㅖ㌧䈅
k&/l&/ki	ㅖ㌧〥
k&/l&/m&/ro	ㅖ㌧ば〹
k&/l&/m&S	ㅖ㌧㍧
k&/l&/mE	ㅖ㌧ㆂ
k&/l&/mE/ha/yE	ㅖ㌧ㆂと〤
k&/l&/me/E	ㅖ㌧㊆【
k&/l&/mun	ㅖ㌧だ
k&/l&S	ㅖ㝓
k&/l&k	ㅖ㔑
k&/l&m	ㅖㆄ
k&/l&t	ㅖ㜥
k&/lE	ㅖぅ
k&/lE/Go/da	ㅖぅ㒗〴
k&/lE/m&/l&8	ㅖぅば䄀
k&/lE/mat	ㅖぅ䈱
k&/lE/pa	ㅖぅ〘
k&/lE/yE	ㅖぅ〤
k&/la/8E	ㅖ〢㊁
k&/la/fE	ㅖ〢㈷
k&/la8	ㅖ㍀
k&/m&/rE/to	ㅖば〕〙
k&/m&/rEt	ㅖば㑣
k&/mE	ㅖㆂ
k&/mES	ㅖ㊒
k&/mEl	ㅖ䐄
k&/ma/nE	ㅖ〖〆
k&/ma/xE	ㅖ〖㈙
k&/mi	ㅖ〃
k&/mu/n&/ro	ㅖ㉀ゔ〹
k&/mu/nE	ㅖ㉀〆
k&/mu/nES	ㅖ㉀㉳
k&/mu/nEt	ㅖ㉀ㄲ
k&/mun	ㅖだ
k&/p&k	ㅖ䁹
k&/pul	ㅖ㥂
k&/rE	ㅖ〕
k&/rE/ha	ㅖ〕と
k&/sa/yi	ㅖ㈆㆕
k&/si	ㅖ々
k&/si/f&m	ㅖ々㙓
k&/si/fE	ㅖ々㈷
k&/si/fE/Sun	ㅖ々㈷㆒
k&/si/fES	ㅖ々㘶
k&/si/fa	ㅖ々㕈
k&/si/fi	ㅖ々㉥
k&/si/yE	ㅖ々〤
k&/sif	ㅖ㙁
k&/sif/go/ri/zun	ㅖ㙁い〵㙂
k&/sif/t&/rE	ㅖ㙁ㄒ〕
k&/sif/t&r	ㅖ㙁〄
k&G	䁈
k&S/ti	䍁ㅔ
k&S/ti/yE	䍁ㅔ〤
k&Sf	䡰
k&Sk	䎕
k&c&l	䀠
k&c&lE	䀡
k&f	㉖
k&f/S&/ro	㉖㍸〹
k&f/SE	㉖ㅠ
k&f/SE/So	㉖ㅠ〈
k&f/SES	㉖㎀
k&f/Sa	㉖〨
k&f/Sa/So	㉖〨〈
k&f/Sa/ro	㉖〨〹
k&f/Sa/to	㉖〨〙
k&f/Sa/tun	㉖〨ㄖ
k&f/Sa/yE	㉖〨〤
k&f/Sat	㉖㥘
k&f/t&r	㉖〄
k&f/xe/li	㉖ゖも
k&fS	㕣
k&fS/du/z&/kE	㕣ㄩㄥㄢ
k&fS/du/z&k	㕣ㄩ㕤
k&m	㉘
k&m/ci	㉘ぉ
k&m/r&N	㉘䉑
k&m/r&n/gE	㉘へぴ
k&m/t&/rE	㉘ㄒ〕
k&m/t&r	㉘〄
k&n	㔩
k&n/d&/mES	㔩㄰㊒
k&n/d&/nE	㔩㄰〆
k&n/d&S	㔩㥄
k&n/dE	㔩あ
k&n/di	㔩び
k&n/dim	㔩㈖
k&nd	㥠
k&ndE	䡩
k&r	㉲
k&r/d&/nE	㉲㄰〆
k&r/d&/nE/SE	㉲㄰〆ㅠ
k&r/d&/nE/Sun	㉲㄰〆㆒
k&r/d&/nES	㉲㄰㉳
k&r/d&m	㉲ㅕ
k&r/d&n	㉲ぱ
k&r/dE	㉲あ
k&r/dam	㉲㊄
k&r/dan	㉲䚖
k&r/dand	㉲䥸
k&r/di	㉲び
k&r/di/za/bt	㉲び㎇䢘
k&r/diS	㉲㦕
k&r/did	㉲㌦
k&r/dim	㉲㈖
k&r/din	㉲㌒
k&r/to/n&/ro	㉲〙ゔ〹
k&r/to/nES	㉲〙㉳
k&r/ton	㉲㠔
k&rd	㈲
k&rd&m	䥦
k&rd&ni	䙣
k&rd&niyE	䙥
k&rdE	䅈
k&rdi	䤦
k&s	㡈
k&s/pEr	㡈㞘
k&s/t&/mi	㡈ㄒ〃
k&si	㖖
kE	ㄢ
kE/Si/d&m	ㄢげㅕ
kE/Si/d&n	ㄢげぱ
kE/Si/dE	ㄢげあ
kE/Si/di	ㄢげび
kE/Si/dim	ㄢげ㈖
kE/Sid	ㄢざ
kE/So	ㄢ〈
kE/So/E	ㄢ〈【
kE/Sun	ㄢ㆒
kE/a/8a/yE	ㄢ〧ぃ〤
kE/a/rE	ㄢ〧〕
kE/b&d	ㄢ㄂
kE/ci	ㄢぉ
kE/fEkr	ㄢう
kE/goft	ㄢㅷ
kE/h&/mE/ci/mun	ㄢㄱㆂぉだ
kE/h&S/ta	ㄢ㈑ゅ
kE/la/sE	ㄢ〢〇
kE/la/sE/tun	ㄢ〢〇ㄖ
kE/la/si	ㄢ〢々
kE/la/sik	ㄢ〢䕱
kE/las	ㄢ㔢
kE/li/dE	ㄢもあ
kE/li/da/yE	ㄢも〴〤
kE/li/nEks	ㄢも㕀
kE/li/sa	ㄢも㈆
kE/li/saS/b&d	ㄢも䄱㄂
kE/lid	ㄢ㥆
kE/na/rE	ㄢ〸〕
kE/na/rES	ㄢ〸て
kE/nar	ㄢ㥷
kE/nar/d&s/tE	ㄢ㥷゗つ
kE/nar/d&s/tES	ㄢ㥷゗㉩
kE/r&/SE	ㄢ㈀ㅠ
kE/r&S	ㄢ㡢
kE/rEm	ㄢ䂆
kE/ra/ye/E	ㄢㅹ䠒【
kE/ris/m&/so	ㄢ㝖ばㅇ
kE/ris/m&s	ㄢ㝖㝗
kE/sa/f&t	ㄢ㈆䂑
kE/sa/yi	ㄢ㈆㆕
kE/si	ㄢ々
kE/t&r/sun	ㄢ〄㡄
kE/ta/b&/mo	ㄢゅ〡㈓
kE/ta/b&m	ㄢゅ㙢
kE/ta/bE	ㄢゅ】
kE/ta/bE/Sun	ㄢゅ】㆒
kE/ta/bE/to	ㄢゅ】〙
kE/ta/bES	ㄢゅ㌕
kE/ta/bEt	ㄢゅ㐥
kE/ta/ba	ㄢゅ〱
kE/ta/ba/Sun	ㄢゅ〱㆒
kE/ta/ba/ki	ㄢゅ〱〥
kE/ta/ba/yi	ㄢゅ〱㆕
kE/ta/bam	ㄢゅ㝠
kE/ta/bi	ㄢゅち
kE/ta/bo	ㄢゅぶ
kE/tab	ㄢ㕄
kE/tab/fo/ru/Si	ㄢ㕄㎆ㄹげ
kE/tab/xu/n&/tE	ㄢ㕄㄃ゔつ
kE/to	ㄢ〙
kE/xe/lo/xob	ㄢゖ㌳〶
kE/ya	ㄢㄈ
kE/zud	ㄢㆀ
kES/di	㌐び
kES/kE/Si	㌐ㄢげ
kES/mES	㌐㊒
kES/miS	㌐㍂
kES/ti	㌐ㅔ
kES/ti/So	㌐ㅔ〈
kES/ti/ha	㌐ㅔと
kES/ti/yE	㌐ㅔ〤
kES/ti/yi	㌐ㅔ㆕
kES/tiS	㌐㝶
kES/v&/ra	㌐㈶ㅹ
kEr/ki/da/yE	㙘〥〴〤
kEr/m&/ro	㙘ば〹
kEr/m&m	㙘㍲
kEr/mE	㙘ㆂ
kEr/ma/ro	㙘〖〹
kEr/mim	㙘㜓
kErm	㚓
ka/8&/z&/ro	㐶ㄷㄥ〹
ka/8&/zE	㐶ㄷㄕ
ka/8&/zES	㐶ㄷㄧ
ka/8&/zEt	㐶ㄷ㚄
ka/8&/za	㐶ㄷ㎇
ka/8&/za/yE	㐶ㄷ㎇〤
ka/8&/zast	㐶ㄷ䌔
ka/8&/zi	㐶ㄷㄵ
ka/8&/zi/haS	㐶ㄷㄵ㉰
ka/8&/ziS	㐶ㄷ㕠
ka/8&/zo	㐶ㄷ㝉
ka/8&z	㐶䆑
ka/8&z/ka/do	㐶䆑㐶〰
ka/bi/nE/t&m	㐶ち〆ㅨ
ka/bi/nEt	㐶ちㄲ
ka/do	㐶〰
ka/do/E	㐶〰【
ka/dom	㐶㤸
ka/dot	㐶㥁
ka/fE	㐶㈷
ka/fE/So	㐶㈷〈
ka/feE	㐶䠆
ka/fi	㐶㉥
ka/fi/yE	㐶㉥〤
ka/gE/li	㐶ぴも
ka/hu	㐶㌨
ka/ka/ku/a	㐶㐶㉗〧
ka/ka/u	㐶㐶ど
ka/ka/u/E	㐶㐶ど【
ka/ka/uS	㐶㐶䁉
ka/ka/um	㐶㐶䁐
ka/l&st	㐶䌤
ka/lEs/kE	㐶䔣ㄢ
ka/lEs/kE/ha	㐶䔣ㄢと
ka/mE/l&n	㐶ㆂ㍕
ka/mEl	㐶䐄
ka/mi	㐶〃
ka/na/lE	㐶〸ぅ
ka/na/lES	㐶〸㈱
ka/nal	㐶㤡
ka/pi/SE/nE/to	㐶ㄉㅠ〆〙
ka/pi/ta/nE	㐶ㄉゅ〆
ka/pi/tan	㐶ㄉ㎖
ka/r&/mE	㐶㈀ㆂ
ka/r&/mo	㐶㈀㈓
ka/r&m	㐶㄄
ka/r&z	㐶䐶
ka/rE	㐶〕
ka/rE/So	㐶〕〈
ka/rE/Sun	㐶〕㆒
ka/rE/mun	㐶〕だ
ka/rES	㐶て
ka/rEt	㐶㑣
ka/ra	㐶ㅹ
ka/ra/Sun	㐶ㅹ㆒
ka/ra/i	㐶ㅹ〷
ka/ra/ib	㐶ㅹ䚘
ka/ra/ro	㐶ㅹ〹
ka/ra/tE	㐶ㅹつ
ka/ra/yE	㐶ㅹ〤
ka/ra/yi	㐶ㅹ㆕
ka/ram	㐶㒀
ka/rat	㐶ㄦ
ka/ri	㐶〵
ka/ri/o	㐶〵㈔
ka/ri/yE	㐶〵〤
ka/riS	㐶㐢
ka/rit	㐶㡱
ka/ro	㐶〹
ka/s&/ro	㐶づ〹
ka/s&t	㐶㞂
ka/sE	㐶〇
ka/sE/bi/Sun	㐶〇ち㆒
ka/se/E	㐶㒑【
ka/va/rEt	㐶ゃ㑣
ka/zu/la	㐶㖅〢
kaS	㌘
kaS/kE	㌘ㄢ
kaS/t&/ni	㌘ㄒこ
kaS/t&/ni/yE	㌘ㄒこ〤
kaf	䌘
kam/pi/yu/tE/r&m	㝹ㄉ㜀つ㄄
kam/pi/yu/tEr	㝹ㄉ㜀㞀
kan/di/dE	㜴びあ
kan/di/da/yE	㜴び〴〤
kan/ga/ru	㜴㍡ㄹ
kan/ga/ru/ha	㜴㍡ㄹと
kan/ga/ru/ha/yi	㜴㍡ㄹと㆕
kan/go/ru	㜴いㄹ
kan/go/ru/ha	㜴いㄹと
kan/go/ru/haS	㜴いㄹ㉰
kan/ti/n&n/tal	㜴ㅔふ䕠
kan/tri	㜴䉖
kan/va	㜴ゃ
kap/SE/nE	㥇ㅠ〆
kap/tEn	㥇䁔
kap/tan	㥇㎖
kapr	䥁
kar	㈣
kar/bord	㈣㈳
kar/d&k	㈣䄢
kar/d&s/ti	㈣゗ㅔ
kar/d&s/ti/ya/to	㈣゗ㅔㄈ〙
kar/d&s/tit	㈣゗䙴
kar/g&/dan	㈣ㄠ䚖
kar/g&r/da/n&m	㈣㈥〴〗
kar/g&r/da/nE	㈣㈥〴〆
kar/g&r/da/na	㈣㈥〴〸
kar/g&r/dan	㈣㈥䚖
kar/g&r/dan/b&d	㈣㈥䚖㄂
kar/ha/yE	㈣と〤
kar/ko/dum	㈣ぇ㔲
kar/m&/gE	㈣ばぴ
kar/mi/rE	㈣〃〕
kar/nE/Gat	㈣〆㠀
kar/na/m&/mun	㈣〸ばだ
kar/tE	㈣つ
kar/to/n&m	㈣〙〗
kar/to/nE	㈣〙〆
kar/to/nE/S&n	㈣〙〆む
kar/to/nES	㈣〙㉳
kar/to/nEt	㈣〙ㄲ
kar/to/na	㈣〙〸
kar/to/na/tun	㈣〙〸ㄖ
kar/to/nast	㈣〙䄁
kar/to/ni	㈣〙こ
kar/to/ni/y&n	㈣〙こ䀸
kar/ton	㈣㠔
kar/tu/nE	㈣ㅡ〆
kar/tu/nEt	㈣ㅡㄲ
kar/tu/ni	㈣ㅡこ
kar/tun	㈣ㄖ
kar/ya/yE	㈣ㄈ〤
karf	䤣
kari	䜹
kat/rin	䈅ㅃ
ke	㕖
ke/&/s&n	㕖ㅀ㐙
ke/&z	㕖、
ke/E	㕖【
ke/fES	㕖㘶
ke/fi	㕖㉥
ke/fi/y&/tES	㕖㉥㍗㉩
ke/kE	㕖ㄢ
ke/kES	㕖㌐
ke/kEt	㕖㊑
ke/ka/vul	㕖㐶䖅
ke/ka/vus	㕖㐶䍳
ke/ki	㕖〥
ke/m&/gE	㕖ばぴ
ke/mi/rim	㕖〃ㆅ
ke/n&	㕖ゔ
ke/n&/ba/y&d	㕖ゔ〱ㅦ
ke/n&/yof/ti	㕖ゔ㉶ㅔ
kef	䕈
kefES	䜑
kek	㑓
ki	〥
ki/&m	〥〓
ki/&n	〥ㅐ
ki/SEt	〥㕁
ki/f&m	〥㙓
ki/fE	〥㈷
ki/fE/So	〥㈷〈
ki/fES	〥㘶
ki/fEt	〥䀱
ki/lo/ba/it	〥㌳〱㒔
ki/lu	〥ぢ
ki/lu/i	〥ぢ〷
ki/lu/yi	〥ぢ㆕
ki/mi/a/yE	〥〃〧〤
ki/mi/ag&/rE	〥〃䀙〕
ki/mi/ag&r	〥〃䅧
ki/mi/ya	〥〃ㄈ
ki/mi/ya/E	〥〃ㄈ【
ki/ro	〥〹
ki/s&/ro	〥づ〹
ki/s&S	〥䆒
ki/s&st	〥㠇
ki/sE	〥〇
ki/sE/hE	〥〇ご
ki/sE/ha	〥〇と
ki/se/E	〥㒑【
ki/se/i	〥㒑〷
ki/vi	〥㒇
ki/yE	〥〤
ki/ya	〥ㄈ
ki/ya/dus/tE/tan	〥ㄈ㜑つ㎖
ki/yo	〥㊕
kiS	㞓
kiS/miS	㞓㍂
kif	䖉
kil/ka	䙘㐶
klik	䎖
ko	ぇ
ko/Ga	ぇ〉
ko/Ga/E	ぇ〉【
ko/Ga/So	ぇ〉〈
ko/Ga/bud	ぇ〉㉄
ko/Ga/i	ぇ〉〷
ko/Ga/in	ぇ〉。
ko/Ga/ro	ぇ〉〹
ko/Ga/yE	ぇ〉〤
ko/Ga/yi	ぇ〉㆕
ko/GaS	ぇ㊂
ko/Gan	ぇ㍅
ko/Gast	ぇ㉵
ko/co/lu	ぇ㤉ぢ
ko/co/lu/E	ぇ㤉ぢ【
ko/cu/lE	ぇ㌉ぅ
ko/dEt	ぇ㈃
ko/du/m&m	ぇㄩ㍲
ko/du/mE	ぇㄩㆂ
ko/du/mE/So	ぇㄩㆂ〈
ko/du/mE/Su/nE	ぇㄩㆂ㐤〆
ko/du/mE/Sun	ぇㄩㆂ㆒
ko/du/mE/mun	ぇㄩㆂだ
ko/du/mE/tun	ぇㄩㆂㄖ
ko/du/mES	ぇㄩ㊒
ko/du/ma	ぇㄩ〖
ko/du/ma/Sun	ぇㄩ〖㆒
ko/du/maS	ぇㄩ䆃
ko/du/mast	ぇㄩ㕢
ko/du/mi	ぇㄩ〃
ko/du/mo	ぇㄩ㈓
ko/dum	ぇ㔲
ko/l&n	ぇ㍕
ko/lE	ぇぅ
ko/la	ぇ〢
ko/la/h&/ro	ぇ〢ㄱ〹
ko/la/hE	ぇ〢ご
ko/la/hES	ぇ〢ㆇ
ko/la/ro	ぇ〢〹
ko/la/yE	ぇ〢〤
ko/laS	ぇ㜗
ko/lah	ぇ䍤
ko/lam	ぇ㎔
ko/li	ぇも
ko/li/yE	ぇも〤
ko/lu/cE/ha/yE	ぇぢでと〤
ko/m&/k&m	ぇば㉘
ko/m&/kE	ぇばㄢ
ko/m&/kE/Sun	ぇばㄢ㆒
ko/m&/kE/tun	ぇばㄢㄖ
ko/m&/kES	ぇば㌐
ko/m&/kEt	ぇば㊑
ko/m&/ki	ぇば〥
ko/m&k	ぇ㉷
ko/m&k/vay	ぇ㉷ㅒ
ko/me/di/yE	ぇ㊆び〤
ko/mo/d&/ro	ぇ㈓㄰〹
ko/mo/dE	ぇ㈓あ
ko/mod	ぇ㕷
ko/n&m	ぇ〗
ko/n&m/mi/r&n	ぇ〗〃へ
ko/n&m/xo/dE/SE	ぇ〗ぷあㅠ
ko/n&n	ぇふ
ko/n&n/d&/ro	ぇふ㄰〹
ko/n&n/d&S	ぇふ㥄
ko/n&n/d&st	ぇふ㎑
ko/n&n/dE	ぇふあ
ko/n&n/de/E	ぇふ䎉【
ko/nE/cE/ra	ぇ〆でㅹ
ko/nE/dad	ぇ〆㙄
ko/nE/mi/xay	ぇ〆〃ㅙ
ko/nE/t&r/su/yi	ぇ〆〄㐣㆕
ko/na	ぇ〸
ko/ni	ぇこ
ko/ni/bi/ya	ぇこちㄈ
ko/nid	ぇ㙆
ko/nim	ぇㄶ
ko/nin	ぇㅵ
ko/r&st	ぇ㞅
ko/rE	ぇ〕
ko/rE/&sb	ぇ〕㤤
ko/rE/ast	ぇ〕䆂
ko/rE/ha	ぇ〕と
ko/rE/hast	ぇ〕㠁
ko/rE/s&g	ぇ〕㠧
ko/so/vo	ぇㅇ㖆
ko/t&/kES	ぇㄒ㌐
ko/t&k	ぇ㘹
ko/tE/So	ぇつ〈
ko/tob	ぇ㡶
koG/hast	䥗㠁
koGa	䌗
koS/nE	㔉〆
koS/t&m	㔉ㅨ
koS/t&n	㔉㍔
koS/ti	㔉ㅔ
koS/ti/yE	㔉ㅔ〤
koSt	䌉
kob/ra	䊔ㅹ
kodum	䀵
kodumi	䡐
koloft&rin	䡠
kom/pot	㡒䎙
kon	け
kon&n	䜸
kon&nd&m	䘀
kon/GEd	け䙤
kon/ba/SE	け〱ㅠ
kon/fE/lEks	け㈷䦂
kon/kur	け䜷
kon/pa/cE	け〘で
kon/sErv	け䝡
kon/to/ro/lES	け〙〹㈱
kon/to/ro/lo	け〙〹㌳
kon/tro/lE	け㑨ぅ
kon/tro/lES	け㑨㈱
kon/tro/lo	け㑨㌳
kon/trol	け㤁
konE	䙲
kor/nEr	䁖㌅
korn/flek/sE	䅕䆆〇
korn/flek/sEt	䅕䆆ㅸ
korn/fleks	䅕䅖
korsE	䍈
kot/lE/tEt	㡁ぅ㕶
kot/lE/ta	㡁ぅゅ
kot/lE/ti	㡁ぅㅔ
kot/lEt	㡁㆔
kr&/S&ro	䂖䂗
kr&S	䂘
krak	䅡
kray	䑨
krim	倉
kris/m&/sE	㥣ば〇
kris/m&s	㥣㝗
kris/to/fE/ra/bin	㥣〙㈷ㅹ぀
ku	㉗
ku/SES	㉗㎀
ku/ba/bax	㉗〱䆓
ku/bun/d&m	㉗㘗ㅕ
ku/c&/Sun	㉗㙈㆒
ku/c&/kE	㉗㙈ㄢ
ku/c&k	㉗㘵
ku/cE	㉗で
ku/cE/kES	㉗で㌐
ku/cE/yE	㉗で〤
ku/ci/k&/ro	㉗ぉㅖ〹
ku/ci/k&/ro/h&r/ci	㉗ぉㅖ〹㈄ぉ
ku/ci/k&m	㉗ぉ㉘
ku/ci/k&n	㉗ぉ㔩
ku/ci/kE	㉗ぉㄢ
ku/ci/kES	㉗ぉ㌐
ku/ci/ka	㉗ぉ㐶
ku/ci/ka/yE	㉗ぉ㐶〤
ku/ci/ki	㉗ぉ〥
ku/ci/x&/la	㉗ぉ㆖〢
ku/cik	㉗㉢
ku/cik/t&/r&n	㉗㉢ㄒへ
ku/cik/t&/rE	㉗㉢ㄒ〕
ku/cik/t&/rast	㉗㉢ㄒ㈠
ku/cik/t&/ri	㉗㉢ㄒ〵
ku/cik/t&r	㉗㉢〄
ku/cik/to/ro	㉗㉢〙〹
ku/cu/lu	㉗㌉ぢ
ku/cu/lu/&n	㉗㌉ぢㅐ
ku/cu/lu/E	㉗㌉ぢ【
ku/cu/lu/S	㉗㌉ぢ㦘
ku/cu/lu/a	㉗㌉ぢ〧
ku/cu/lu/a/Es/ke/t&n	㉗㌉ぢ〧㈸㕖㍔
ku/cu/lu/a/yE	㉗㌉ぢ〧〤
ku/cu/lu/ast	㉗㌉ぢ䆂
ku/cu/lu/i	㉗㌉ぢ〷
ku/cu/lu/yE	㉗㌉ぢ〤
ku/cu/lut	㉗㌉㦒
ku/d&/kE	㉗㄰ㄢ
ku/d&/kE/So	㉗㄰ㄢ〈
ku/d&/kE/mun	㉗㄰ㄢだ
ku/d&/kEs/ta/ni/ha	㉗㄰䊕ゅこと
ku/d&/kEs/tan	㉗㄰䊕㎖
ku/d&/kim	㉗㄰䡙
ku/d&k	㉗䄢
ku/dum	㉗㔲
ku/hE	㉗ご
ku/hEt	㉗㍐
ku/ho	㉗㌱
ku/ku	㉗㉗
ku/kus	㉗㡆
ku/kut	㉗㠰
ku/lE	㉗ぅ
ku/lE/cE/ha	㉗ぅでと
ku/lEr	㉗䞘
ku/nES	㉗㉳
ku/ne/E	㉗㤐【
ku/rE	㉗〕
ku/rE/yE	㉗〕〤
ku/roS	㉗㥃
ku/s&/ro	㉗づ〹
ku/sE	㉗〇
ku/sE/ha	㉗〇と
ku/sE/yi	㉗〇㆕
ku/sun	㉗㡄
ku/ta	㉗ゅ
ku/ta/hE	㉗ゅご
ku/tah	㉗䘹
kuS	㌩
kuculu	䕸
kuculu&m	㠣
kuf/t&	㤵ㄒ
kuh	㌁
kuk	䝩
kun	㝅
kur	䜷
kus	㡆
kwan	䍀
l&/8&d	㌧㖓
l&/8E	㌧㊁
l&/GEt	㌧㔐
l&/bE	㌧】
l&/bE/haS	㌧】㉰
l&/bE/to	㌧】〙
l&/bE/yE	㌧】〤
l&/bEt	㌧㐥
l&/baS	㌧㐓
l&/bu	㌧ら
l&/fiN	㌧䤆
l&/ha/zE	㌧とㄕ
l&/kE	㌧ㄢ
l&/kE/ha	㌧ㄢと
l&/kE/yE	㌧ㄢ〤
l&/l&/kE	㌧㌧ㄢ
l&/tif	㌧䘸
l&/va/S&/kE	㌧ゃ㍸ㄢ
l&/va/S&/ka/yE	㌧ゃ㍸㐶〤
l&/va/S&/ko	㌧ゃ㍸ぇ
l&/va/S&k	㌧ゃ㜨
l&/zEr	㌧㔧
l&8	䄀
l&h/G&/ro	㙔㆗〹
l&h/ni	㙔こ
l&h/sE	㙔〇
l&h/zE	㙔ㄕ
l&n/d&n	㍕ぱ
l&n/gun	㍕䝙
l&vaS&ki	䎅
lE	ぅ
lE/ba/s&m	ぅ〱㑷
lE/ba/sE	ぅ〱〇
lE/ba/sE/tE	ぅ〱〇つ
lE/ba/sE/to	ぅ〱〇〙
lE/ba/sES	ぅ〱㐃
lE/ba/sEt	ぅ〱ㅸ
lE/ba/sa	ぅ〱㈆
lE/ba/sa/So	ぅ〱㈆〈
lE/ba/sa/to	ぅ〱㈆〙
lE/ba/sa/yE	ぅ〱㈆〤
lE/ba/saS	ぅ〱䄱
lE/ba/sam	ぅ〱㡑
lE/ba/sat	ぅ〱㝔
lE/ba/si	ぅ〱々
lE/bas	ぅ㠥
lE/bas/xa/bEt	ぅ㠥し㐥
lE/ga	ぅ㍡
lE/go/a	ぅい〧
lE/go/a/yE	ぅい〧〤
lE/go/at	ぅい㥔
lE/go/i	ぅい〷
lE/go/i/yE	ぅい〷〤
lE/go/to	ぅい〙
lE/gom	ぅ㕧
lE/hE/Sun	ぅご㆒
lE/hES	ぅㆇ
lE/va	ぅゃ
lE/va/hE	ぅゃご
lE/vast	ぅ䄂
lE/z&t	ぅ㡵
lEh	㒅
lEn/gE	㒆ぴ
lEn/gaS	㒆㠅
la	〢
la/8&/rE	〢ㄷ〕
la/G&/v&r/di/yE	〢㆗㍉び〤
la/bE/haS	〢】㉰
la/bod	〢㠡
la/hut	〢䕐
la/k&m	〢㉘
la/l&/ro	〢㌧〹
la/l&m	〢ㆄ
la/lE	〢ぅ
la/lEh	〢㒅
la/la	〢〢
la/yE	〢〤
la/ya	〢ㄈ
la/zE/mES	〢ㄕ㊒
la/zEm	〢㞇
la/za/ni/ya	〢㎇こㄈ
la/za/ni/ya/to	〢㎇こㄈ〙
lak/la/kE	䁳〢ㄢ
lak/poS/t&/ro	䁳㖉ㄒ〹
lak/poS/tE	䁳㖉つ
lak/poS/ta	䁳㖉ゅ
lak/poSt	䁳㠐
lal	㦆
lam/pi	㎔ㄉ
lam/pist	㎔䘁
lamp	䜴
le/la	㑢〢
li/f&m	も㙓
li/fi	も㉥
li/li	もも
li/li/a/yE	もも〧〤
li/li/ya	ももㄈ
li/li/ya/b&/lE	ももㄈ〡ぅ
li/li/ya/ro	ももㄈ〹
li/li/ya/yE	ももㄈ〤
li/li/yam	もも㉂
li/li/yast	もも㑔
li/mu	も㉀
li/mu/Si/rin	も㉀げㅃ
li/sE	も〇
li/sEt	もㅸ
li/va/nE	もゃ〆
li/va/nE/mun	もゃ〆だ
li/va/nE/to	もゃ〆〙
li/va/nE/tun	もゃ〆ㄖ
li/va/nES	もゃ㉳
li/va/nEt	もゃㄲ
li/va/na/yE	もゃ〸〤
li/va/ni	もゃこ
li/van	も㥗
li/zi	もㄵ
li/zi/ni/ya	もㄵこㄈ
li/zi/ni/yast	もㄵこ㑔
lif	㙦
lik/nEkst	㝄䑥
liliya	䈷
lin/k&m	ㄤ㉘
lin/kEt	ㄤ㊑
lis	㢀
lis/tE	㢀つ
list	䕴
lit/ri/yE	㕨〵〤
liz	䝗
lo/8&/ta	㌳ㄷゅ
lo/go	㌳い
lo/go/E	㌳い【
lo/goS	㌳㍹
lo/pEt	㌳㥕
lo/rEl	㌳䦃
lo8/m&/mo	䉲ば㈓
lo8/m&/ro	䉲ば〹
lo8/m&/to	䉲ば〙
lo8/m&st	䉲䍱
lo8/m&t	䉲㝡
lo8/mE	䉲ㆂ
lo8/mE/ha/ro	䉲ㆂと〹
lo8/mE/ha/yE	䉲ㆂと〤
lo8/mE/ha/yi	䉲ㆂと㆕
lo8/mE/yE	䉲ㆂ〤
lop	䀅
lot/f&n	㒙㔀
lot/fE	㒙㈷
lotf	䘷
lu/bi/ya	ぢちㄈ
lu/bi/ya/So	ぢちㄈ〈
lu/bi/ya/to	ぢちㄈ〙
lu/bi/ya/yE	ぢちㄈ〤
lu/bi/yaS	ぢち㐸
lu/l&S	ぢ㝓
lu/lE	ぢぅ
lu/nE	ぢ〆
lu/nE/&S	ぢ〆䍩
lu/nE/yE	ぢ〆〤
lus	䢕
m&/8&/zE/yE	ばㄷㄕ〤
m&/8a/l&m	ばぃㆄ
m&/8a/lE	ばぃぅ
m&/8a/lE/ha	ばぃぅと
m&/8a/z&/mun	ばぃㄥだ
m&/8a/z&S	ばぃㅓ
m&/8a/z&m	ばぃ㑶
m&/8a/zE	ばぃㄕ
m&/8a/zE/da/rE	ばぃㄕ〴〕
m&/8a/zE/dar	ばぃㄕ㐑
m&/8a/zE/hE	ばぃㄕご
m&/8a/zE/ha	ばぃㄕと
m&/8a/zE/ha/yE	ばぃㄕと〤
m&/8a/zE/yE	ばぃㄕ〤
m&/8a/zE/yi	ばぃㄕ㆕
m&/G&/lE	ば㆗ぅ
m&/G&/lE/yE	ば㆗ぅ〤
m&/Ga/ni	ば〉こ
m&/Gid	ば䦓
m&/Gu/nE	ば㄀〆
m&/Gu/no	ば㄀ㆈ
m&/Gun	ばㄔ
m&/S&d	ば䘃
m&/ba/da	ば〱〴
m&/d&/ni	ば㄰こ
m&/g&r	ば㈥
m&/gE	ばぴ
m&/gu/li	ば〒も
m&/h&/lES	ばㄱ㈱
m&/ha/r&/tE	ばと㈀つ
m&/ha/r&t	ばと㡓
m&/ha/r&t/da/ri/yE	ばと㡓〴〵〤
m&/ha/r&t/dar	ばと㡓㐑
m&/hin	ば䥩
m&/kE	ばㄢ
m&/l&/8E	ば㌧㊁
m&/l&/8ES	ば㌧㚗
m&/l&/ba/nE	ば㌧〱〆
m&/l&/ba/ni	ば㌧〱こ
m&/l&/ban	ば㌧䁕
m&/l&/k&m	ば㌧㉘
m&/l&/kE	ば㌧ㄢ
m&/l&/kE/yE	ば㌧ㄢ〤
m&/l&/kE/yi	ば㌧ㄢ㆕
m&/l&8	ば䄀
m&/lE/k&/ro	ばぅㅖ〹
m&/lE/k&m	ばぅ㉘
m&/lE/kE	ばぅㄢ
m&/lE/kE/ha	ばぅㄢと
m&/lE/kE/yE	ばぅㄢ〤
m&/lE/kE/yi	ばぅㄢ㆕
m&/lE/ki	ばぅ〥
m&/lE/ki/yE	ばぅ〥〤
m&/lu/mE	ばぢㆂ
m&/lum	ばㄡ
m&/mu/l&n	ば㉀㍕
m&/mu/li	ば㉀も
m&/mu/ri/y&t	ば㉀〵㉦
m&/n&m	ば〗
m&/n&n	ばふ
m&/nE	ば〆
m&/na/rE	ば〸〕
m&/na/yi	ば〸㆕
m&/ni	ばこ
m&/ni/So	ばこ〈
m&/ni/dar	ばこ㐑
m&/ni/yE	ばこ〤
m&/ni/yi	ばこ㆕
m&/niS	ば㊇
m&/no	ばㆈ
m&/nom	ば䌥
m&/nul	ば䦉
m&/ri/y&m	ば〵㥹
m&/ri/zE	ば〵ㄕ
m&/ri/zi	ば〵ㄵ
m&/riz	ばㅣ
m&/ru/f&n	ばㄹ㔀
m&/s&/l&/ro	ばづ㌧〹
m&/s&/l&n	ばづ㍕
m&/s&/lE	ばづぅ
m&/s&/lE/yE	ばづぅ〤
m&/sir	ば㘒
m&/t&l	ば㘣
m&/t&r/s&/kE	ば〄づㄢ
m&/t&r/s&k	ば〄㐒
m&/va/dE	ばゃあ
m&/va/dES	ばゃ㈴
m&/va/di	ばゃび
m&/z&/So	ばㄥ〈
m&/z&S	ばㅓ
m&/zE	ばㄕ
m&/zE/dar	ばㄕ㐑
m&/zE/r&t	ばㄕ㡓
m&/zE/r&t/xa/hi	ばㄕ㡓しょ
m&/zE/yE	ばㄕ〤
m&/zE/yi	ばㄕ㆕
m&/zE/yi/yE	ばㄕ㆕〤
m&8/zE	㙃ㄕ
m&8azEyE	䞂
m&8z	䍃
m&G/bu/rE	䎄ら〕
m&G/bu/rE/Sun	䎄ら〕㆒
m&G/bur	䎄䈀
m&Gbur	䐵
m&S/8at	㍧㠴
m&S/8u/lE	㍧㖒ぅ
m&S/8u/li	㍧㖒も
m&S/8ul	㍧䄃
m&S/ku/kE	㍧㉗ㄢ
m&S/ku/ki	㍧㉗〥
m&S/kuk	㍧䝩
m&S/ru/ti/yE	㍧ㄹㅔ〤
m&S/v&/rEt	㍧㈶㑣
m&S/vE/r&t	㍧㔈㡓
m&d/rE/s&/SE	㈰〕づㅠ
m&d/rE/s&S	㈰〕䆒
m&d/rE/sE	㈰〕〇
m&d/rE/sE/ha/tun	㈰〕〇とㄖ
m&d/rE/sE/yE	㈰〕〇〤
m&f/hu/mo	䊉㌨㈓
m&h/S&/ri	䄡㍸〵
m&h/bub	䄡䜱
m&h/dE	䄡あ
m&h/dE/ku/d&/kE	䄡あ㉗㄰ㄢ
m&h/dE/ku/d&/kE/Sun	䄡あ㉗㄰ㄢ㆒
m&h/dE/ku/d&/kES	䄡あ㉗㄰㌐
m&h/dE/ku/d&k	䄡あ㉗䄢
m&h/dud	䄡㕳
m&h/mu/di	䄡㉀び
m&h/mud	䄡䥴
m&h/naz	䄡㘲
m&h/rum	䄡䂀
m&h/sa	䄡㈆
m&h/ta/bi	䄡ゅち
m&ks	䉓
m&m/nu/n&m	㍲ㄳ〗
m&m/nun	㍲㞈
m&muliyE	䖑
m&n	㄁
m&n/da/dE	㄁〴あ
m&n/fi	㄁㉥
m&n/gu/lim	㄁〒䜰
m&n/gul	㄁㠃
m&n/mu/n&m	㄁㉀〗
m&n/mun	㄁だ
m&n/tE/8i	㄁つ㌶
m&n/zE/lE	㄁ㄕぅ
m&n/zu/r&m	㄁㖅㄄
m&n/zu/rE	㄁㖅〕
m&n/zu/rE/Sun	㄁㖅〕㆒
m&n/zu/rE/tE	㄁㖅〕つ
m&n/zu/rE/to	㄁㖅〕〙
m&n/zu/rEt	㄁㖅㑣
m&n/zur	㄁䆈
m&r/Gun	㚀ㄔ
m&r/bu/tE	㚀らつ
m&r/but	㚀䜐
m&r/dE	㚀あ
m&r/da	㚀〴
m&r/do/m&m	㚀〰㍲
m&r/do/ma/za/ra/nE/yi	㚀〰〖㎇ㅹ〆㆕
m&r/do/mi	㚀〰〃
m&r/dom	㚀㤸
m&r/h&/l&/ro	㚀ㄱ㌧〹
m&r/h&/lE	㚀ㄱぅ
m&r/h&/lE/yE	㚀ㄱぅ〤
m&r/hu/mE	㚀㌨ㆂ
m&r/t&/bE	㚀ㄒ】
m&r/y&/mo/zad	㚀㍗㈓㦁
m&r/y&m	㚀㥹
m&r/zE/i/yE	㚀ㄕ〷〤
m&r/zi	㚀ㄵ
m&r/zi/y&st	㚀ㄵ䑒
m&r/zi/yE	㚀ㄵ〤
m&rd	䈩
m&rg	䠶
m&s&l&n	䔴
m&s/nu/i	㝗ㄳ〷
m&s/r&f	㝗㉃
m&s/ti	㝗ㅔ
m&s/to	㝗〙
m&s/u/dE	㝗どあ
m&s/u/do	㝗ど〰
m&s/ud	㝗䦑
m&s/x&/r&n	㝗㆖へ
m&s/x&/r&st	㝗㆖㞅
m&s/x&/rE/yi	㝗㆖〕㆕
m&t/l&/bE	㝡㌧】
m&x/lu/tE	䐇ぢつ
m&x/lut	䐇㦒
m&x/m&/l&k	䐇ば㔑
m&x/m&l	䐇䌇
m&x/su/s&n	䐇㐣㐙
m&x/su/sE	䐇㐣〇
m&x/su/sES	䐇㐣㐃
m&x/sus	䐇䀒
m&z/r&/&S	䙁㈀䍩
m&z/r&/E/dar	䙁㈀【㐑
mE	ㆂ
mE/d&/Sun	ㆂ㄰㆒
mE/d&S	ㆂ㥄
mE/dE	ㆂあ
mE/da/dE	ㆂ〴あ
mE/da/dE/S&m	ㆂ〴あ㆑
mE/da/dE/to	ㆂ〴あ〙
mE/da/dES	ㆂ〴㈴
mE/dad	ㆂ㙄
mE/dad/r&n/gi	ㆂ㙄へん
mE/dad/r&n/gi/yam	ㆂ㙄へん㉂
mE/dad/r&n/git	ㆂ㙄へ䌃
mE/dad/t&/raS	ㆂ㙄ㄒㄐ
mE/l&/tE	ㆂ㌧つ
mE/l&t	ㆂ㜥
mE/li/yun	ㆂも䝖
mE/mi/du/nam	ㆂ〃ㄩ䄸
mE/sE	ㆂ〇
mE/xa	ㆂし
mE/xad	ㆂえ
mE8/da/ri	䚆〴〵
mES/ma/el	㊒〖䥵
mEh/mu/nE	㍱㉀〆
mEh/mu/nEt	㍱㉀ㄲ
mEh/mu/na	㍱㉀〸
mEh/mu/na/tu/nE	㍱㉀〸ㅡ〆
mEh/mu/na/yE	㍱㉀〸〤
mEh/mu/na/yi	㍱㉀〸㆕
mEh/mu/ni	㍱㉀こ
mEh/mu/ni/&/ro	㍱㉀こㅀ〹
mEh/mu/ni/mun	㍱㉀こだ
mEh/mu/ni/piS	㍱㉀こ㞁
mEh/mu/ni/yE	㍱㉀こ〤
mEh/mu/niS	㍱㉀㊇
mEh/mun	㍱だ
mEh/r&/ba/ni	㍱㈀〱こ
mEh/r&/bu/n&/ro	㍱㈀らゔ〹
mEh/r&/bu/n&m	㍱㈀ら〗
mEh/r&/bu/n&n	㍱㈀らふ
mEh/r&/bu/nE	㍱㈀ら〆
mEh/r&/bu/nE/yi	㍱㈀ら〆㆕
mEh/r&/bu/na/yi	㍱㈀ら〸㆕
mEh/r&/bu/ni	㍱㈀らこ
mEh/r&/bu/ni/E	㍱㈀らこ【
mEh/r&/bu/ni/yE	㍱㈀らこ〤
mEh/r&/bu/ni/yi/E	㍱㈀らこ㆕【
mEh/r&/bu/nit	㍱㈀ら㡧
mEh/r&/bun	㍱㈀㘗
mEh/r&/bun/t&/rin	㍱㈀㘗ㄒㅃ
mEh/rE	㍱〕
mEhr	䀇
mEhr/nu/So	䀇ㄳ〈
mEhr/nuS	䀇䒈
mEnc	䡈
mEr/li/nE	㐘も〆
mEr/lin	㐘ㄤ
mEr/lin/b&/raS	㐘ㄤ〡ㄐ
mEr/med	㐘䅴
mEr/si	㐘々
mErsi	䚐
mEs/lE	ㄅぅ
mEs/lEn/kE	ㄅ㒆ㄢ
mEs/va/kE	ㄅゃㄢ
mEs/va/kE/to	ㄅゃㄢ〙
mEs/va/kEt	ㄅゃ㊑
mEs/va/ki	ㄅゃ〥
mEs/vak	ㄅ㡦
mEsvak	䒃
mEt/ro	㞗〹
mEtr	䔥
ma	〖
ma/G&/ra	〖㆗ㅹ
ma/G&/ra/ha	〖㆗ㅹと
ma/G&/ra/ha/yE	〖㆗ㅹと〤
ma/G&/ra/yE	〖㆗ㅹ〤
ma/G&/raS	〖㆗ㄐ
ma/G&/ram	〖㆗㒀
ma/GE/ra	〖㌲ㅹ
ma/Gik	〖䤃
ma/S&/ir	〖㍸䎘
ma/Sa/la	〖〨〢
ma/Si/n&m	〖げ〗
ma/Si/nE	〖げ〆
ma/Si/nE/Sun	〖げ〆㆒
ma/Si/nES	〖げ㉳
ma/Si/nEt	〖げㄲ
ma/Si/na	〖げ〸
ma/Si/na/to	〖げ〸〙
ma/Si/na/xo/la/sE	〖げ〸ぷ〢〇
ma/Si/no	〖げㆈ
ma/Si/yES	〖げ㥒
ma/Sin	〖゙
ma/Sin/hE/sa/bE	〖゙ご㈆】
ma/Soud	〖䦒
ma/ba/lan	〖〱㍒
ma/d&/rE	〖㄰〕
ma/d&/rE/tun	〖㄰〕ㄖ
ma/d&/rES	〖㄰て
ma/d&/rEt	〖㄰㑣
ma/d&/ra	〖㄰ㅹ
ma/d&/ri	〖㄰〵
ma/d&r	〖ㆉ
ma/d&r/So/h&/r&m	〖ㆉ〈ㄱ㄄
ma/d&r/bo/zor/gE	〖ㆉぶ㌙ぴ
ma/d&r/bo/zor/ga/yE	〖ㆉぶ㌙㍡〤
ma/da/gas/ka/rE	〖〴䈆㐶〕
ma/da/gas/kar	〖〴䈆㈣
ma/di	〖び
ma/dis	〖䤙
ma/hE	〖ご
ma/hEt	〖㍐
ma/ha	〖と
ma/han	〖ㅉ
ma/hi	〖ょ
ma/hi/cE/ha/yE	〖ょでと〤
ma/hi/fo/ru/S&m	〖ょ㎆ㄹ㆑
ma/hi/fo/ru/SE	〖ょ㎆ㄹㅠ
ma/hi/fo/ru/Sa	〖ょ㎆ㄹ〨
ma/hi/fo/ru/Si	〖ょ㎆ㄹげ
ma/hi/fo/ru/Sim	〖ょ㎆ㄹ㕥
ma/hi/fo/ruS	〖ょ㎆ㅰ
ma/hi/gi/ri	〖ょん〵
ma/hi/ha/yE	〖ょと〤
ma/hi/po/lo/xor	〖ょべ㌳さ
ma/hi/tE	〖ょつ
ma/hi/yE	〖ょ〤
ma/hi/ya	〖ょㄈ
ma/hi/ya/mun	〖ょㄈだ
ma/hi/ya/nE	〖ょㄈ〆
ma/hi/yaS	〖ょ㐸
ma/hiS	〖㡣
ma/hit	〖䕷
ma/ka/ro/hut	〖㐶〹䕐
ma/ka/ro/ni	〖㐶〹こ
ma/ka/ro/ni/So	〖㐶〹こ〈
ma/ka/ro/ni/ya	〖㐶〹こㄈ
ma/ka/ro/nit	〖㐶〹㡧
ma/ko	〖ぇ
ma/lE	〖ぅ
ma/lE/kE/yim	〖ぅㄢ䌦
ma/li/SE	〖もㅠ
ma/li/yat	〖も㥶
ma/liS	〖䀘
ma/lid	〖㥆
ma/ma	〖〖
ma/ma/do	〖〖〰
ma/ma/n&	〖〖ゔ
ma/ma/n&m	〖〖〗
ma/ma/nE	〖〖〆
ma/ma/nE/S&m	〖〖〆㆑
ma/ma/nE/So	〖〖〆〈
ma/ma/nE/Su/nE	〖〖〆㐤〆
ma/ma/nE/Sun	〖〖〆㆒
ma/ma/nE/mun	〖〖〆だ
ma/ma/nES	〖〖㉳
ma/ma/nEt	〖〖ㄲ
ma/ma/ni	〖〖こ
ma/ma/no	〖〖ㆈ
ma/ma/o/u/SE	〖〖㈔どㅠ
ma/mad	〖䚔
ma/man	〖〩
ma/man/bE/gu	〖〩】〒
ma/man/ba/baS	〖〩〱㐓
ma/man/bo/zor/g&/mE	〖〩ぶ㌙ㄠㆂ
ma/man/bo/zor/g&m	〖〩ぶ㌙㍑
ma/man/bo/zor/gE	〖〩ぶ㌙ぴ
ma/man/bo/zor/gE/to	〖〩ぶ㌙ぴ〙
ma/man/bo/zor/gES	〖〩ぶ㌙㐔
ma/man/bo/zor/gES/xa/lE	〖〩ぶ㌙㐔しぅ
ma/man/bo/zor/gEt	〖〩ぶ㌙䉥
ma/man/bo/zor/gat	〖〩ぶ㌙䐁
ma/man/bo/zorg	〖〩ぶ㈈
ma/man/vay	〖〩ㅒ
ma/mi	〖〃
ma/mi/ro	〖〃〹
ma/mi/yE	〖〃〤
ma/mo/u/SE	〖㈓どㅠ
ma/n&nd	〖䐒
ma/o/Sa/i/ri	〖㈔〨〷〵
ma/r&/ro	〖㈀〹
ma/rE	〖〕
ma/ra/bEl	〖ㅹ㠂
ma/ri	〖〵
ma/ri/ya/nE	〖〵ㄈ〆
ma/ri/ya/na/han	〖〵ㄈ〸ㅉ
ma/ri/yan	〖〵㍷
ma/ro	〖〹
ma/ro/E/i	〖〹【〷
ma/sa/G&m	〖㈆㍈
ma/sa/GEt	〖㈆㔐
ma/sa/Gi	〖㈆㌆
ma/saG	〖゘
ma/sul	〖䊂
ma/ti/ki	〖ㅔ〥
ma/tik	〖㝲
ma/yE	〖〤
ma/yi	〖㆕
ma/z&n/d&/ran	〖㊖㄰㔁
ma/zE/i/yE	〖ㄕ〷〤
ma/za/rat	〖㎇ㄦ
ma/zi/ki	〖ㄵ〥
maS	䆃
mac/ma/li	䠀〖も
mad&rbozorg	䡶
mah	㉉
mah/di	㉉び
mah/di/yE	㉉び〤
mah/pi/Su/ni	㉉ㄉ㐤こ
mah/pi/Su/ni/m&n	㉉ㄉ㐤こ㄁
mah/pi/Su/ni/y&m	㉉ㄉ㐤こ㥹
mahpiSuni	䝐
mal	㔹
malad	䄅
maman	䞆
mamanES	䒐
mar	㉧
mar/&n/k&/bu/ti	㉧ㅐㅖらㅔ
mar/ga/rit	㉧㍡㡱
mar/kE	㉧ㄢ
mar/kES	㉧㌐
mar/ka/yE	㉧㐶〤
mar/ki	㉧〥
mas/kE	䄴ㄢ
mas/kES	䄴㌐
mas/kEt	䄴㊑
mas/pid	䄴㘧
mas/tE	䄴つ
mas/tE/to	䄴つ〙
mas/tES	䄴㉩
mas/tEt	䄴㕶
mask	䄲
mast	㕢
me/dun/bE/c&r/xi	㊆㙣】㈘㌢
me/go	㊆い
me/lE/to	㊆ぅ〙
me/mu/n&st	㊆㉀䂄
me/mu/nE	㊆㉀〆
me/mu/na	㊆㉀〸
me/mu/na/ro	㊆㉀〸〹
me/mu/no	㊆㉀ㆈ
me/mun	㊆だ
mel	䉵
mhm	㒘
mi	〃
mi/&r/zE	〃㡐ㄕ
mi/G&n/g&m	〃㙳㍑
mi/G&n/g&n	〃㙳㙡
mi/G&n/gid	〃㙳䜵
mi/G&n/gim	〃㙳ㆆ
mi/Go/yi	〃㒗㆕
mi/S&/v&d	〃㍸䁀
mi/S&m	〃㆑
mi/S&n	〃む
mi/SE	〃ㅠ
mi/SE/a/fa/rom	〃ㅠ〧㕈䘣
mi/SE/bE	〃ㅠ】
mi/SEm	〃䎆
mi/Si	〃げ
mi/Si/n&m	〃げ〗
mi/Si/n&n	〃げふ
mi/Si/nE	〃げ〆
mi/Si/nE/ka/rE	〃げ〆㐶〕
mi/Si/ni	〃げこ
mi/Sim	〃㕥
mi/Sin	〃゙
mi/So/d&n	〃〈ぱ
mi/So/d&n/v&/li	〃〈ぱ㈶も
mi/So/di	〃〈び
mi/So/din	〃〈㌒
mi/Sod	〃㈵
mi/Su/r&/mEt	〃㐤㈀㞗
mi/Su/r&m	〃㐤㄄
mi/Su/ri	〃㐤〵
mi/Su/riS	〃㐤㐢
mi/Su/rim	〃㐤ㆅ
mi/a/o	〃〧㈔
mi/ay	〃㎈
mi/aym	〃䕦
mi/ayn	〃㥈
mi/b&/r&/mEt	〃〡㈀㞗
mi/b&/r&m	〃〡㄄
mi/b&/r&n	〃〡へ
mi/b&/rE	〃〡〕
mi/b&/ri	〃〡〵
mi/b&/ri/mE/Sun	〃〡〵ㆂ㆒
mi/b&/rin	〃〡ㅃ
mi/b&n/dE	〃㕲あ
mi/b&n/di	〃㕲び
mi/b&st	〃㙖
mi/ba/ram/nEr/sE/ri	〃〱㒀㌅〇〵
mi/ba/z&m	〃〱㑶
mi/ba/zi	〃〱ㄵ
mi/bi/n&/mES	〃ちゔ㊒
mi/bi/n&/mEt	〃ちゔ㞗
mi/bi/n&/tES	〃ちゔ㉩
mi/bi/n&m	〃ち〗
mi/bi/n&n	〃ちふ
mi/bi/nE	〃ち〆
mi/bi/ni	〃ちこ
mi/bi/ni/mES	〃ちこ㊒
mi/bi/nim	〃ちㄶ
mi/bo/r&m	〃ぶ㄄
mi/bor/di	〃㐁び
mi/bor/din	〃㐁㌒
mi/c&r/xE	〃㈘㈙
mi/c&r/xi	〃㈘㌢
mi/c&s/bE	〃䄕】
mi/c&s/p&n	〃䄕㒖
mi/c&s/pE	〃䄕ㄣ
mi/c&s/pi	〃䄕ㄉ
mi/c&s/pid	〃䄕㘧
mi/c&s/pu/n&n	〃䄕ゆふ
mi/c&s/pu/ni	〃䄕ゆこ
mi/c&s/pun/d&m	〃䄕䅷ㅕ
mi/cE/S&m	〃で㆑
mi/ci/n&m	〃ぉ〗
mi/ci/nE	〃ぉ〆
mi/ci/ni	〃ぉこ
mi/d&m	〃ㅕ
mi/d&m/ci	〃ㅕぉ
mi/d&n	〃ぱ
mi/dE	〃あ
mi/dE/to	〃あ〙
mi/da/d&n	〃〴ぱ
mi/da/di	〃〴び
mi/da/n&m	〃〴〗
mi/da/r&m	〃〴㄄
mi/da/r&n	〃〴へ
mi/da/rE	〃〴〕
mi/da/ri	〃〴〵
mi/da/rid	〃〴䁆
mi/da/rin	〃〴ㅃ
mi/daS/t&m	〃㈂ㅨ
mi/daSt	〃㑑
mi/dad	〃㙄
mi/di	〃び
mi/di/d&n	〃びぱ
mi/di/di	〃びび
mi/di/di/han	〃びびㅉ
mi/diS	〃㦕
mi/did	〃㌦
mi/dim	〃㈖
mi/din	〃㌒
mi/do/&n	〃〰ㅐ
mi/do/yi	〃〰㆕
mi/do/yid	〃〰㕩
mi/doz/dE	〃㕆あ
mi/du/n&/n&m	〃ㄩゔ〗
mi/du/n&m	〃ㄩ〗
mi/du/n&n	〃ㄩふ
mi/du/nE	〃ㄩ〆
mi/du/nEs/t&m	〃ㄩ㑄ㅨ
mi/du/nEs/t&n	〃ㄩ㑄㍔
mi/du/nEs/ti	〃ㄩ㑄ㅔ
mi/du/nEst	〃ㄩ㘉
mi/du/ni	〃ㄩこ
mi/du/ni/did	〃ㄩこ㌦
mi/du/nid	〃ㄩ㙆
mi/du/nim	〃ㄩㄶ
mi/f&h/m&m	〃㔤㍲
mi/f&h/m&n	〃㔤㄁
mi/f&h/mE	〃㔤ㆂ
mi/f&h/mi	〃㔤〃
mi/f&h/mi/d&m	〃㔤〃ㅕ
mi/g&S/t&m	〃㙨ㅨ
mi/g&St	〃䀂
mi/g&m	〃㍑
mi/g&n	〃㙡
mi/g&r/d&m	〃㈥ㅕ
mi/g&r/d&n	〃㈥ぱ
mi/g&r/dE	〃㈥あ
mi/g&r/di	〃㈥び
mi/g&r/dim	〃㈥㈖
mi/gE	〃ぴ
mi/gE/da/da/Si	〃ぴ〴〴げ
mi/gE/rEf/t&n	〃ぴ㌤㍔
mi/gE/rEf/tim	〃ぴ㌤㐩
mi/gE/rEft	〃ぴ㚁
mi/gi	〃ん
mi/gi/r&/mEt	〃ん㈀㞗
mi/gi/r&m	〃ん㄄
mi/gi/r&n	〃んへ
mi/gi/rE	〃ん〕
mi/gi/ri	〃ん〵
mi/gi/rim	〃んㆅ
mi/gi/rin	〃んㅃ
mi/gim	〃ㆆ
mi/gin	〃㜩
mi/gof/t&m	〃ㅳㅨ
mi/gof/t&n	〃ㅳ㍔
mi/gof/tE	〃ㅳつ
mi/gof/tES	〃ㅳ㉩
mi/gof/ti	〃ㅳㅔ
mi/gof/tim	〃ㅳ㐩
mi/goft	〃ㅷ
mi/gu/y&d	〃〒ㅦ
mi/k&n	〃㔩
mi/k&n/d&n	〃㔩ぱ
mi/k&r/d&/mE/Sun	〃㉲㄰ㆂ㆒
mi/k&r/d&m	〃㉲ㅕ
mi/k&r/d&n	〃㉲ぱ
mi/k&r/dE	〃㉲あ
mi/k&r/di	〃㉲び
mi/k&r/di/&lan	〃㉲び䡵
mi/k&r/di/xob	〃㉲び〶
mi/k&r/dim	〃㉲㈖
mi/k&r/din	〃㉲㌒
mi/k&rd	〃㈲
mi/kE/S&m	〃ㄢ㆑
mi/kE/S&n	〃ㄢむ
mi/kE/SE	〃ㄢㅠ
mi/kE/Si	〃ㄢげ
mi/kE/Si/d&n	〃ㄢげぱ
mi/kE/Si/di	〃ㄢげび
mi/kE/Si/m&n	〃ㄢげ㄁
mi/kE/Sid	〃ㄢざ
mi/kaSt	〃䘒
mi/ko/S&/mES	〃ぇ㍸㊒
mi/ko/S&/mEt	〃ぇ㍸㞗
mi/ko/Si	〃ぇげ
mi/ko/n&m	〃ぇ〗
mi/ko/n&m/v&/li	〃ぇ〗㈶も
mi/ko/n&n	〃ぇふ
mi/ko/nE	〃ぇ〆
mi/ko/ni	〃ぇこ
mi/ko/nid	〃ぇ㙆
mi/ko/nim	〃ぇㄶ
mi/ko/nim/ha/la	〃ぇㄶと〢
mi/ko/nin	〃ぇㅵ
mi/l&r/zE	〃㌇ㄕ
mi/lE	〃ぅ
mi/lE/gof/t&n	〃ぅㅳ㍔
mi/lE/hE	〃ぅご
mi/ma/l&m	〃〖ㆄ
mi/ma/li	〃〖も
mi/ma/n&nd	〃〖䐒
mi/mi/r&n	〃〃へ
mi/mi/rE	〃〃〕
mi/mi/ri	〃〃〵
mi/mi/rim	〃〃ㆅ
mi/mu/n&n	〃㉀ふ
mi/mu/nE	〃㉀〆
mi/mu/ni	〃㉀こ
mi/mun/dE	〃だあ
mi/n&/va/zi	〃ゔゃㄵ
mi/n&/va/zin	〃ゔゃ䖐
mi/nE/S&st	〃〆㖃
mi/nE/SEst	〃〆䑵
mi/nE/SEst/xa/lE	〃〆䑵しぅ
mi/nE/vES/ti	〃〆㝨ㅔ
mi/nE/vESt	〃〆㡷
mi/nE/vi/s&m	〃〆㒇㑷
mi/nE/vi/sE	〃〆㒇〇
mi/nE/vi/sim	〃〆㒇䍔
mi/ni/bus	〃こ㐧
mi/ni/vi/sE	〃こ㒇〇
mi/nu	〃ㄳ
mi/nu/&m	〃ㄳ〓
mi/nu/E	〃ㄳ【
mi/nu/ro	〃ㄳ〹
mi/nu/yE	〃ㄳ〤
mi/p&/r&/ro	〃ㅆ㈀〹
mi/p&/r&m	〃ㅆ㄄
mi/p&/r&n	〃ㅆへ
mi/p&/rE	〃ㅆ〕
mi/p&/rid	〃ㅆ䁆
mi/p&/rim	〃ㅆㆅ
mi/p&/rin	〃ㅆㅃ
mi/p&/s&n/di	〃ㅆ㐙び
mi/p&/z&m	〃ㅆ㑶
mi/p&/z&n	〃ㅆ㊖
mi/p&/zE	〃ㅆㄕ
mi/p&/zi	〃ㅆㄵ
mi/pa/S&m	〃〘㆑
mi/pa/ri	〃〘〵
mi/pi/cim	〃ㄉ䕥
mi/pi/cu/ni	〃ㄉ㌉こ
mi/por/s&m	〃㉕㑷
mi/por/si	〃㉕々
mi/por/sim	〃㉕䍔
mi/poxt	〃䈂
mi/pu/S&m	〃ゆ㆑
mi/pu/S&n	〃ゆむ
mi/pu/SE	〃ゆㅠ
mi/r&8/s&m	〃㐠㑷
mi/r&8/sE	〃㐠〇
mi/r&8/si	〃㐠々
mi/r&8/sid	〃㐠㘁
mi/r&f/t&m	〃㉃ㅨ
mi/r&f/t&n	〃㉃㍔
mi/r&f/tE	〃㉃つ
mi/r&f/ti	〃㉃ㅔ
mi/r&f/tim	〃㉃㐩
mi/r&ft	〃す
mi/r&m	〃㄄
mi/r&n	〃へ
mi/rE	〃〕
mi/rE/s&m	〃〕㑷
mi/rE/sE	〃〕〇
mi/rE/si	〃〕々
mi/rE/sid	〃〕㘁
mi/rE/su/n&m	〃〕㐣〗
mi/ri	〃〵
mi/ri/z&m	〃〵㑶
mi/ri/z&n	〃〵㊖
mi/ri/zE	〃〵ㄕ
mi/ri/zi	〃〵ㄵ
mi/ri/zim	〃〵㍓
mi/rim	〃ㆅ
mi/rin	〃ㅃ
mi/ru/nE	〃ㄹ〆
mi/sE	〃〇
mi/sa/z&m	〃㈆㑶
mi/sa/z&n	〃㈆㊖
mi/sa/zE	〃㈆ㄕ
mi/sa/zi	〃㈆ㄵ
mi/sa/zim	〃㈆㍓
mi/sax/t&n	〃䄶㍔
mi/sax/tim	〃䄶㐩
mi/su/zE	〃㐣ㄕ
mi/su/zi	〃㐣ㄵ
mi/su/zu/nE/n&	〃㐣㖅〆ゔ
mi/su/zu/ni	〃㐣㖅こ
mi/su/zun/di	〃㐣㙂び
mi/su/zund	〃㐣䕀
mi/suxt	〃䀉
mi/t&/rE/kE	〃ㄒ〕ㄢ
mi/t&r/s&m	〃〄㑷
mi/t&r/s&n	〃〄㐙
mi/t&r/sE	〃〄〇
mi/t&r/si	〃〄々
mi/t&r/su/ni	〃〄㐣こ
mi/tE/rE/ku/nim	〃つ〕㉗ㄶ
mi/tu/n&m	〃ㅡ〗
mi/tu/n&n	〃ㅡふ
mi/tu/nE	〃ㅡ〆
mi/tu/nEs/t&m	〃ㅡ㑄ㅨ
mi/tu/nEs/ti	〃ㅡ㑄ㅔ
mi/tu/nEs/tim	〃ㅡ㑄㐩
mi/tu/nEst	〃ㅡ㘉
mi/tu/ni	〃ㅡこ
mi/tu/nim	〃ㅡㄶ
mi/tu/nin	〃ㅡㅵ
mi/v&/mun	〃㈶だ
mi/v&/ro	〃㈶〹
mi/vE	〃㔈
mi/vE/ha/ro	〃㔈と〹
mi/vE/ha/yE	〃㔈と〤
mi/vE/ha/yi/yE	〃㔈と㆕〤
mi/vE/yE	〃㔈〤
mi/vE/yi	〃㔈㆕
mi/x&/r&m	〃㆖㄄
mi/x&/rE	〃㆖〕
mi/x&/ri	〃㆖〵
mi/x&/ri/di	〃㆖〵び
mi/x&/rim	〃㆖ㆅ
mi/x&/ro	〃㆖〹
mi/x&n/dE	〃ぁあ
mi/x&n/di	〃ぁび
mi/xa	〃し
mi/xa/b&m	〃し㙢
mi/xa/b&n	〃し㕲
mi/xa/bE	〃し】
mi/xa/bi	〃しち
mi/xa/bid	〃し㘤
mi/xa/bu/nE	〃しら〆
mi/xa/in	〃し。
mi/xa/r&m	〃し㄄
mi/xa/rE	〃し〕
mi/xa/rE/cE	〃し〕で
mi/xa/ri	〃し〵
mi/xa/rid	〃し䁆
mi/xa/ru/nE	〃しㄹ〆
mi/xa/yi	〃し㆕
mi/xad	〃え
mi/xam	〃㎓
mi/xan	〃ひ
mi/xas/t&m	〃㑕ㅨ
mi/xas/t&n	〃㑕㍔
mi/xas/tE	〃㑕つ
mi/xas/ti	〃㑕ㅔ
mi/xas/tid	〃㑕䔄
mi/xas/tim	〃㑕㐩
mi/xas/tin	〃㑕㌥
mi/xast	〃䀧
mi/xay	〃ㅙ
mi/xaym	〃㕸
mi/xo/r&/mE/Sun	〃ぷ㈀ㆂ㆒
mi/xo/r&/mES	〃ぷ㈀㊒
mi/xo/r&/mEt	〃ぷ㈀㞗
mi/xo/r&/nE/mun	〃ぷ㈀〆だ
mi/xo/r&/nES	〃ぷ㈀㉳
mi/xo/r&/tES	〃ぷ㈀㉩
mi/xo/r&/tEt	〃ぷ㈀㕶
mi/xo/r&m	〃ぷ㄄
mi/xo/r&n	〃ぷへ
mi/xo/rE	〃ぷ〕
mi/xo/ri	〃ぷ〵
mi/xo/ri/mES	〃ぷ〵㊒
mi/xo/rim	〃ぷㆅ
mi/xo/rin	〃ぷㅃ
mi/xor/d&m	〃さㅕ
mi/xor/di	〃さび
mi/xor/dim	〃さ㈖
mi/xor/din	〃さ㌒
mi/xord	〃㐱
mi/xu/n&m	〃㄃〗
mi/xu/nE	〃㄃〆
mi/xu/na	〃㄃〸
mi/xu/nal	〃㄃㤡
mi/xu/ni	〃㄃こ
mi/xu/nim	〃㄃ㄶ
mi/xun/d&/mES	〃め㄰㊒
mi/xun/d&m	〃めㅕ
mi/xun/di	〃めび
mi/xun/dim	〃め㈖
mi/xun/din	〃め㌒
mi/y&o	〃䜘
mi/ya	〃ㄈ
mi/ya/i	〃ㄈ〷
mi/ya/im	〃ㄈ䈇
mi/ya/m&/d&n	〃ㄈばぱ
mi/ya/nE	〃ㄈ〆
mi/ya/r&/tE/Sun	〃ㄈ㈀つ㆒
mi/ya/r&m	〃ㄈ㄄
mi/ya/r&n	〃ㄈへ
mi/ya/rE	〃ㄈ〕
mi/ya/ri	〃ㄈ〵
mi/ya/rim	〃ㄈㆅ
mi/ya/rin	〃ㄈㅃ
mi/ya/vord	〃ㄈ㙠
mi/yad	〃㉆
mi/yam	〃㉂
mi/yan	〃㍷
mi/yay	〃㌡
mi/yo/vor/di	〃㊕㈕び
mi/yo/vord	〃㊕㙠
mi/yof/t&m	〃㉶ㅨ
mi/yof/tE	〃㉶つ
mi/yof/ta/dE	〃㉶ゅあ
mi/yof/tad	〃㉶㊘
mi/yof/ti	〃㉶ㅔ
mi/yu	〃㜀
mi/yu/m&/d&/min	〃㜀ば㄰㉴
mi/yu/m&/d&n	〃㜀ばぱ
mi/yu/m&/dE	〃㜀ばあ
mi/yu/m&/di	〃㜀ばび
mi/yu/m&/din	〃㜀ば㌒
mi/yu/m&d	〃㜀㈰
mi/yu/nE/yi	〃㜀〆㆕
mi/z&/d&m	〃ㄥㅕ
mi/z&/d&n	〃ㄥぱ
mi/z&/di	〃ㄥび
mi/z&/din	〃ㄥ㌒
mi/z&/n&m	〃ㄥ〗
mi/z&/n&n	〃ㄥふ
mi/z&/nE	〃ㄥ〆
mi/z&/nEt	〃ㄥㄲ
mi/z&/ni	〃ㄥこ
mi/z&/ni/mE/Sun	〃ㄥこㆂ㆒
mi/z&/nid	〃ㄥ㙆
mi/z&/nim	〃ㄥㄶ
mi/z&/nin	〃ㄥㅵ
mi/z&/rE	〃ㄥ〕
mi/z&d	〃㘙
mi/z&nd	〃䦔
mi/zE	〃ㄕ
mi/zES	〃ㄧ
mi/za/dan	〃㎇䚖
mi/za/nam	〃㎇䄸
mi/za/r&/mES	〃㎇㈀㊒
mi/za/r&/mEt	〃㎇㈀㞗
mi/za/r&/n&	〃㎇㈀ゔ
mi/za/r&/tEt	〃㎇㈀㕶
mi/za/r&m	〃㎇㄄
mi/za/r&n	〃㎇へ
mi/za/ri	〃㎇〵
mi/za/riS	〃㎇㐢
mi/za/rim	〃㎇ㆅ
mi/za/y&m	〃㎇㥹
mi/za/yi	〃㎇㆕
mi/zaS/t&m	〃っㅨ
mi/zaSt	〃㖔
mi/zad	〃㦁
mi/zan	〃㦂
miS/k&/nE	㍂ㅖ〆
miS/k&/ni	㍂ㅖこ
miS/k&n/di	㍂㔩び
miS/k&s/ti	㍂㡈ㅔ
miS/k&st	㍂㜕
miS/ma/el	㍂〖䥵
miS/mar	㍂㉧
miS/mo/r&m	㍂㈓㄄
miS/mo/ri	㍂㈓〵
miS/n&/v&m	㍂ゔ㦙
miS/n&/vi	㍂ゔ㒇
miS/n&/vid	㍂ゔ㘀
miS/n&/vim	㍂ゔ䘂
miS/na/s&/mES	㍂〸づ㊒
miS/na/s&m	㍂〸㑷
miS/na/s&n	㍂〸㐙
miS/na/si	㍂〸々
miS/na/sim	㍂〸䍔
miS/nax/t&n	㍂䀢㍔
miSE	䢈
miSk&nE	䤷
mic/rob	䥑㍶
miduni	䙸
mif/rEs/t&m	䄆㚕ㅨ
mif/rEs/tE	䄆㚕つ
mif/rEs/ta/d&/nES	䄆㚕ゅ㄰㉳
mif/rEs/ta/d&m	䄆㚕ゅㅕ
mif/rEs/ti	䄆㚕ㅔ
mif/ru/S&n	䄆ㄹむ
mif/ru/SE	䄆ㄹㅠ
mif/rux/t&n	䄆䑕㍔
mif/rux/tE	䄆䑕つ
mif/ruxt	䄆䔢
mig/z&/rE	䑶ㄥ〕
mig/z&/rund	䑶ㄥ䑷
mig/z&St	䑶㙕
mik/nE	䉐〆
mik/ni	䉐こ
mik/ro/ba	䉐〹〱
mik/ro/ba/yE	䉐〹〱〤
mik/ro/fo/nE/tun	䉐〹㎆〆ㄖ
mik/ro/fo/nEt	䉐〹㎆ㄲ
mik/rob	䉐㍶
mik/sE	䉐〇
mil/ko/nE	䞇ぇ〆
milk	㞆
min/da/z&/mES	㉴〴ㄥ㊒
min/da/z&/mEt	㉴〴ㄥ㞗
min/da/z&/tES	㉴〴ㄥ㉩
min/da/z&m	㉴〴㑶
min/da/zE	㉴〴ㄕ
min/da/zi	㉴〴ㄵ
min/da/zi/Sun	㉴〴ㄵ㆒
min/da/ziS	㉴〴㕠
min/da/zim	㉴〴㍓
min/da/zin	㉴〴䖐
min/dax/t&n	㉴ㅧ㍔
min/daxt	㉴㙅
mis/tE	㝱つ
mis/ti	㝱ㅔ
mis/tik/for/sE	㝱㝲㝳〇
mis/tik/fors	㝱㝲㝴
mit&rEkE	䕔
mit&rs&m	䝕
mituni	䖀
mix	䔹
mixay	䠨
mixordi	䥥
miyu	䒙
miyuyE	䔀
miyuyiE	䜗
miz	㈗
mo	㈓
mo/&/d&b	㈓ㅀ䑤
mo/&/lE/mE	㈓ㅀぅㆂ
mo/&/lE/mE/Sun	㈓ㅀぅㆂ㆒
mo/&/lE/mE/mun	㈓ㅀぅㆂだ
mo/&/lE/mE/to	㈓ㅀぅㆂ〙
mo/&/lE/mES	㈓ㅀぅ㊒
mo/&/lE/ma/Sun	㈓ㅀぅ〖㆒
mo/&/lE/ma/yE	㈓ㅀぅ〖〤
mo/&/lE/mi	㈓ㅀぅ〃
mo/&/lEm	㈓ㅀ䑓
mo/&/m&	㈓ㅀば
mo/&/ma	㈓ㅀ〖
mo/&/ma/So	㈓ㅀ〖〈
mo/&/ma/i	㈓ㅀ〖〷
mo/&/rE/fi	㈓ㅀ〕㉥
mo/&/rE/fi/Sun	㈓ㅀ〕㉥㆒
mo/&/t&l	㈓ㅀ㘣
mo/&/z&/mi	㈓ㅀㄥ〃
mo/&/zE/mi	㈓ㅀㄕ〃
mo/8&/d&/m&/ti	㈓ㄷ㄰ばㅔ
mo/8&/va	㈓ㄷゃ
mo/8&/vi	㈓ㄷ㒇
mo/8E	㈓㊁
mo/8E/ha	㈓㊁と
mo/8E/ha/yi	㈓㊁と㆕
mo/8E/yE	㈓㊁〤
mo/8E/yi	㈓㊁㆕
mo/8a/bEl	㈓ぃ㠂
mo/8e	㈓䆘
mo/GE/zE	㈓㌲ㄕ
mo/Gu/dE	㈓㄀あ
mo/Gu/da/tE	㈓㄀〴つ
mo/S&/x&/s&m	㈓㍸㆖㑷
mo/S&/x&s	㈓㍸㐄
mo/Sa/vE/rE	㈓〨㔈〕
mo/a/fE/8&m	㈓〧㈷ㅶ
mo/a/fE/8i	㈓〧㈷㌶
mo/ba/rE/zE	㈓〱〕ㄕ
mo/ba/rE/zE/b&/lE	㈓〱〕ㄕ〡ぅ
mo/bay/l&/mo	㈓㝧㌧㈓
mo/bay/lE	㈓㝧ぅ
mo/bay/lE/tun	㈓㝧ぅㄖ
mo/bay/lEt	㈓㝧㆔
mo/bayl	㈓㤳
mo/bi	㈓ち
mo/bi/di/ko	㈓ちびぇ
mo/bi/lES	㈓ち㈱
mo/bi/na	㈓ち〸
mo/bi/na/ki/yE	㈓ち〸〥〤
mo/ca/lE	㈓ㅘぅ
mo/cul	㈓䡃
mo/d&/ta	㈓㄰ゅ
mo/d&/ti	㈓㄰ㅔ
mo/d&t	㈓ゐ
mo/d&t/ha	㈓ゐと
mo/d&t/hast	㈓ゐ㠁
mo/di/rE	㈓び〕
mo/dir	㈓㡰
mo/fid	㈓䁑
mo/h&/m&/dE	㈓ㄱばあ
mo/h&/m&d	㈓ㄱ㈰
mo/hE/mE	㈓ごㆂ
mo/hE/mi	㈓ご〃
mo/hEm	㈓㜖
mo/ha/fE/z&t	㈓と㈷㡵
mo/ha/sE/bE	㈓と〇】
mo/ka/fat	㈓㐶䉇
mo/ka/lE/mE/yE	㈓㐶ぅㆂ〤
mo/la/hE/zE/yE	㈓〢ごㄕ〤
mo/la/yEm/t&r	㈓〢䞑〄
mo/mad/bad	㈓䚔㑉
mo/n&/z&/m&n	㈓ゔㄥ㄁
mo/n&/z&/ma/Su/n&n	㈓ゔㄥ〖㐤ふ
mo/na/sE/b&n	㈓〸〇㕲
mo/na/sE/bE	㈓〸〇】
mo/na/sE/bi	㈓〸〇ち
mo/na/sEb	㈓〸䈠
mo/pol	㈓㘳
mo/r&/b&	㈓㈀〡
mo/r&/b&/i/E	㈓㈀〡〷【
mo/r&/ba	㈓㈀〱
mo/r&/bi	㈓㈀ち
mo/r&/bi/d&s/ta/to	㈓㈀ち゗ゅ〙
mo/r&/bi/tun	㈓㈀ちㄖ
mo/r&/bi/yE	㈓㈀ち〤
mo/r&/bi/ya	㈓㈀ちㄈ
mo/r&/bi/ya/hE	㈓㈀ちㄈご
mo/r&/biS	㈓㈀㙴
mo/r&/bit	㈓㈀䄧
mo/r&/k&/bE	㈓㈀ㅖ】
mo/r&/k&b	㈓㈀䕒
mo/r&/t&/bi	㈓㈀ㄒち
mo/r&/t&b	㈓㈀㕵
mo/rE/dE	㈓〕あ
mo/rE/di	㈓〕び
mo/rEd	㈓㠈
mo/ra/8E/b&m	㈓ㅹ㊁㙢
mo/ra/8E/b&t	㈓ㅹ㊁㡩
mo/ra/8E/bE	㈓ㅹ㊁】
mo/ra/8E/bES	㈓ㅹ㊁㌕
mo/ra/8Eb	㈓ㅹ䈥
mo/s&/l&t	㈓づ㜥
mo/sa/bE/8&t	㈓㈆】㍴
mo/sa/bE/8E	㈓㈆】㊁
mo/sa/bE/8E/yE	㈓㈆】㊁〤
mo/sa/fE/rE	㈓㈆㈷〕
mo/sa/fE/ra	㈓㈆㈷ㅹ
mo/sa/fEr/b&/ri/yE	㈓㈆䉦〡〵〤
mo/t&/ka/han	㈓ㄒ㐶ㅉ
mo/t&/sE/f&m	㈓ㄒ〇㙓
mo/t&/sEl	㈓ㄒ㦈
mo/t&r/GEm	㈓〄䑐
mo/tE/n&/vE	㈓つゔ㔈
mo/tE/v&/GE	㈓つ㈶㌲
mo/tE/v&/GE/yE	㈓つ㈶㌲〤
mo/tE/v&/sEt	㈓つ㈶ㅸ
mo/to/rE	㈓〙〕
mo/to/rE/SE	㈓〙〕ㅠ
mo/to/ro/SE	㈓〙〹ㅠ
mo/tor	㈓㉅
mo/v&/f&/8i/y&t/a/miz	㈓㈶ㅂ㌶㉦〧㈗
mo/v&/f&8	㈓㈶䍐
mo/va/GE	㈓ゃ㌲
mo/va/zE/b&t	㈓ゃㄕ㡩
mo/va/zE/bE	㈓ゃㄕ】
mo/va/zE/bE/Si	㈓ゃㄕ】げ
mo/va/zE/bES	㈓ゃㄕ㌕
mo/va/zEb	㈓ゃ㝒
mo/va/zi	㈓ゃㄵ
mo/va/zi/E	㈓ゃㄵ【
mo/x&m	㈓㜹
mo/xa/lE/f&m	㈓しぅ㙓
mo/xa/lE/fE	㈓しぅ㈷
mo/z&/f&/r&m	㈓ㄥㅂ㄄
mo/z&/f&/ri/yan	㈓ㄥㅂ〵㍷
mo/z&/f&r	㈓ㄥ㊔
mo/z&m	㈓㑶
mo/z&x/r&/fi/yE	㈓㕱㈀㉥〤
mo/zE	㈓ㄕ
mo/zES	㈓ㄧ
mo/za	㈓㎇
mo/za/hE/mE	㈓㎇ごㆂ
mo/za/hE/mE/tun	㈓㎇ごㆂㄖ
mo/za/kE/rE	㈓㎇ㄢ〕
mo/zu	㈓㖅
moG	䘗
moG/ri	䘗〵
moG/ri/a/yE	䘗〵〧〤
moG/ri/ya	䘗〵ㄈ
moS/gE/lE	㜅ぴぅ
moS/gE/lE/Sun	㜅ぴぅ㆒
moS/gE/lES	㜅ぴ㈱
moS/gE/li	㜅ぴも
moS/gEl	㜅㝦
moS/kE/l&/mo	㜅ㄢ㌧㈓
moS/kE/lE	㜅ㄢぅ
moS/kE/lE/Sun	㜅ㄢぅ㆒
moS/kE/la/ti	㜅ㄢ〢ㅔ
moS/kE/li	㜅ㄢも
moS/kEl	㜅㜆
moS/kEl/t&r	㜅㜆〄
moS/t&/rEk	㜅ㄒ㢙
moS/t&/ri	㜅ㄒ〵
moS/t&/ri/a/yE	㜅ㄒ〵〧〤
moS/t&/ri/ya/Sun	㜅ㄒ〵ㄈ㆒
moS/t&/ri/ya/tun	㜅ㄒ〵ㄈㄖ
moS/tE	㜅つ
moS/tES	㜅㉩
moS/tEt	㜅㕶
moS/ti	㜅ㅔ
moSt	䑀
mob/l&/ro	䀩㌧〹
mob/l&m	䀩ㆄ
mob/lE	䀩ぅ
mob/lE/Sun	䀩ぅ㆒
mob/sE/rE	䀩〇〕
mob/sEr	䀩䌁
mobl	㤙
moc	㢆
moh&m&d	䊄
moh/k&/mi/du/n&m	㜉ㅖ〃ㄩ〗
moh/k&/miS	㜉ㅖ㍂
moh/k&m	㜉㉘
moh/k&m/t&r	㜉㉘〄
moh/r&/ro	㜉㈀〹
moh/rE	㜉〕
moh/rE/aS	㜉〕㒈
moh/rE/ha	㜉〕と
moh/rE/ha/yE	㜉〕と〤
moh/rE/ha/yi	㜉〕と㆕
moh/rE/haS	㜉〕㉰
moh/rE/yE	㜉〕〤
moh/sEn	㜉䄤
moh/t&/r&m	㜉ㄒ㄄
mom/kE/nE	㔅ㄢ〆
mom/kEn	㔅䊖
mon/f&/GEr	㜠ㅂ㜡
mon/t&/zE/rE	㜠ㄒㄕ〕
mon/t&/zE/rE/t&n	㜠ㄒㄕ〕㍔
mon/t&/zE/rE/tE	㜠ㄒㄕ〕つ
mon/t&/zE/rE/tu/n&m	㜠ㄒㄕ〕ㅡ〗
mon/t&/zE/rE/tu/n&n	㜠ㄒㄕ〕ㅡふ
mon/tE/ha	㜠つと
mor/8E	㌰㊁
mor/8E/mun	㌰㊁だ
mor/8a/bi	㌰ぃち
mor/d&m	㌰ㅕ
mor/d&n	㌰ぱ
mor/dE	㌰あ
mor/di	㌰び
mor/va/ri/dE	㌰ゃ〵あ
mor8	㤔
mord	㘅
mos/b&t	䉈㡩
mos/t&/8E/lE	䉈ㄒ㊁ぅ
mos/t&/n&/dE	䉈ㄒゔあ
mot/S&/kE/r&m	䈈㍸ㄢ㄄
mot/m&/E/n&m	䈈ば【〗
mot/m&/E/nE	䈈ば【〆
mot/m&/E/ni	䈈ば【こ
mot/m&/En	䈈ば㉠
mox/t&/lE/f&n	䍇ㄒぅ㔀
mox/t&/lEf	䍇ㄒ䐔
mox/t&/r&/ma	䍇ㄒ㈀〖
moz	䍖
moz&f&r	䢀
mu	㉀
mu/S&/kE	㉀㍸ㄢ
mu/S&/kEt	㉀㍸㊑
mu/S&/ki	㉀㍸〥
mu/S&/ki/ya	㉀㍸〥ㄈ
mu/S&/ko	㉀㍸ぇ
mu/S&/ro	㉀㍸〹
mu/S&k	㉀㜨
mu/S&m	㉀㆑
mu/SE	㉀ㅠ
mu/Sa	㉀〨
mu/Si	㉀げ
mu/cu/lu	㉀㌉ぢ
mu/dE/ra/zi	㉀あㅹㄵ
mu/di/ni	㉀びこ
mu/h&/vi/Gi	㉀ㄱ㒇㌆
mu/ha	㉀と
mu/ha/SE	㉀とㅠ
mu/ha/yE	㉀と〤
mu/haS	㉀㉰
mu/ham	㉀㜲
mu/hat	㉀㕂
mu/na/rEn/Gi	㉀〸㈩㌆
mu/nu/i	㉀ㄳ〷
mu/si/8i	㉀々㌶
mu/si/8i/yi	㉀々㌶㆕
mu/si/8it	㉀々䡅
mu/yE	㉀〤
muS	㑗
muS/mar	㑗㉧
mul/ti/vi/ta/min	䠅ㅔ㒇ゅ㉴
mun/d&n	だぱ
mun/dE	だあ
mun/din	だ㌒
mund	䀃
mur/cE	㙑で
mur/cE/hE	㙑でご
mur/cE/ha	㙑でと
mur/cE/ham	㙑で㜲
mur/cE/hast	㙑で㠁
mur/cE/yE	㙑で〤
mut	䜆
n&	ゔ
n&/8a/SE	ゔぃㅠ
n&/8a/Si	ゔぃげ
n&/8a/Si/E	ゔぃげ【
n&/8a/Si/b&/rE	ゔぃげ〡〕
n&/8a/Si/ha/mun	ゔぃげとだ
n&/8a/Si/ha/yE	ゔぃげと〤
n&/8a/Si/y&n	ゔぃげ䀸
n&/8a/Si/yE	ゔぃげ〤
n&/8a/Si/ya	ゔぃげㄈ
n&/8a/Si/ya/to	ゔぃげㄈ〙
n&/8a/Si/ya/yE	ゔぃげㄈ〤
n&/8a/Sim	ゔぃ㕥
n&/8a/Sit	ゔぃ䉒
n&/Eh/sas	ゔ㜇䆔
n&/Go/&m	ゔ㒗〓
n&/Go/E	ゔ㒗【
n&/Go/i	ゔ㒗〷
n&/Go/yi	ゔ㒗㆕
n&/Go/yi/d&n	ゔ㒗㆕ぱ
n&/Go/yi/dE	ゔ㒗㆕あ
n&/S&m	ゔ㆑
n&/S&n	ゔむ
n&/SE	ゔㅠ
n&/Si	ゔげ
n&/Si/ni	ゔげこ
n&/Sin	ゔ゙
n&/So	ゔ〈
n&/So/d&m	ゔ〈ㅕ
n&/So/d&n	ゔ〈ぱ
n&/So/dE	ゔ〈あ
n&/So/di	ゔ〈び
n&/So/din	ゔ〈㌒
n&/Sod	ゔ㈵
n&/b&/r&/tEt	ゔ〡㈀㕶
n&/b&n/di	ゔ㕲び
n&/b&nd	ゔ㍆
n&/b&r	ゔ㈤
n&/b&s/tim	ゔ㐐㐩
n&/ba/S&m	ゔ〱㆑
n&/ba/SE	ゔ〱ㅠ
n&/ba/Si	ゔ〱げ
n&/ba/Sid	ゔ〱ざ
n&/ba/Sim	ゔ〱㕥
n&/ba/Sin	ゔ〱゙
n&/ba/y&/dE	ゔ〱㍗あ
n&/ba/y&d	ゔ〱ㅦ
n&/baS	ゔ㐓
n&/bat	ゔ㐡
n&/bi/n&m	ゔち〗
n&/bi/n&n	ゔちふ
n&/bi/nE	ゔち〆
n&/bi/na	ゔち〸
n&/bi/ni	ゔちこ
n&/bin	ゔ぀
n&/bo/rE	ゔぶ〕
n&/bor/d&m	ゔ㐁ㅕ
n&/bor/dE	ゔ㐁あ
n&/bord	ゔ㈳
n&/bu/d&m	ゔらㅕ
n&/bu/d&n	ゔらぱ
n&/bu/dE	ゔらあ
n&/bu/di	ゔらび
n&/bu/dim	ゔら㈖
n&/bu/din	ゔら㌒
n&/bud	ゔ㉄
n&/c&s/pE	ゔ䄕ㄣ
n&/c&s/pu/nin	ゔ䄕ゆㅵ
n&/c&s/pun/dE	ゔ䄕䅷あ
n&/cE/Si/d&m	ゔでげㅕ
n&/d&m	ゔㅕ
n&/dE	ゔあ
n&/dE/rE	ゔあ〕
n&/da/d&m	ゔ〴ㅕ
n&/da/dE	ゔ〴あ
n&/da/di	ゔ〴び
n&/da/r&/ro	ゔ〴㈀〹
n&/da/r&m	ゔ〴㄄
n&/da/r&n	ゔ〴へ
n&/da/rE	ゔ〴〕
n&/da/ri	ゔ〴〵
n&/da/rim	ゔ〴ㆅ
n&/da/rin	ゔ〴ㅃ
n&/daS/t&m	ゔ㈂ㅨ
n&/daS/t&n	ゔ㈂㍔
n&/daS/tE	ゔ㈂つ
n&/daS/ti	ゔ㈂ㅔ
n&/daS/tim	ゔ㈂㐩
n&/daSt	ゔ㑑
n&/dar	ゔ㐑
n&/dar/di	ゔ㐑び
n&/di	ゔび
n&/di/d&/mES	ゔび㄰㊒
n&/di/d&m	ゔびㅕ
n&/di/d&n	ゔびぱ
n&/di/dE	ゔびあ
n&/di/dES	ゔび㈴
n&/di/di	ゔびび
n&/di/diS	ゔび㦕
n&/di/din	ゔび㌒
n&/di/gE	ゔびぴ
n&/did	ゔ㌦
n&/din	ゔ㌒
n&/doz/di/dE	ゔ㕆びあ
n&/du/n&n	ゔㄩふ
n&/f&/rE	ゔㅂ〕
n&/f&/ri	ゔㅂ〵
n&/f&/rin	ゔㅂㅃ
n&/f&/sE	ゔㅂ〇
n&/f&/sEt	ゔㅂㅸ
n&/f&h/m&m	ゔ㔤㍲
n&/f&h/mE	ゔ㔤ㆂ
n&/f&h/mi/d&m	ゔ㔤〃ㅕ
n&/f&h/mi/dE	ゔ㔤〃あ
n&/f&h/mi/di	ゔ㔤〃び
n&/f&h/mid	ゔ㔤㔥
n&/f&m	ゔ㙓
n&/f&r	ゔ㊔
n&/f&s	ゔゕ
n&/fE	ゔ㈷
n&/fE/tE	ゔ㈷つ
n&/fEt	ゔ䀱
n&/g&m	ゔ㍑
n&/gE/rEf/t&m	ゔぴ㌤ㅨ
n&/gE/rEf/ti	ゔぴ㌤ㅔ
n&/gE/rEf/tiS	ゔぴ㌤㝶
n&/gE/rEft	ゔぴ㚁
n&/gi	ゔん
n&/gi/r&m	ゔん㄄
n&/gi/rE	ゔん〕
n&/gi/ri	ゔん〵
n&/gi/rin	ゔんㅃ
n&/gim	ゔㆆ
n&/gin	ゔ㜩
n&/gir	ゔㅱ
n&/gof/t&m	ゔㅳㅨ
n&/gof/t&n	ゔㅳ㍔
n&/gof/tE	ゔㅳつ
n&/gof/ti	ゔㅳㅔ
n&/gof/tim	ゔㅳ㐩
n&/gof/tin	ゔㅳ㌥
n&/goft	ゔㅷ
n&/gu	ゔ〒
n&/h&N	ゔ㑡
n&/h&n/ga	ゔ㐈㍡
n&/h&n/gi	ゔ㐈ん
n&/k&/nES	ゔㅖ㉳
n&/k&n	ゔ㔩
n&/k&n/dE	ゔ㔩あ
n&/k&r/d&/nE	ゔ㉲㄰〆
n&/k&r/d&m	ゔ㉲ㅕ
n&/k&r/d&n	ゔ㉲ぱ
n&/k&r/dE	ゔ㉲あ
n&/k&r/di	ゔ㉲び
n&/k&r/dim	ゔ㉲㈖
n&/k&r/din	ゔ㉲㌒
n&/k&rd	ゔ㈲
n&/kE/Si/d&m	ゔㄢげㅕ
n&/kE/Si/dE	ゔㄢげあ
n&/kE/Si/di	ゔㄢげび
n&/ko/n&m	ゔぇ〗
n&/ko/n&n	ゔぇふ
n&/ko/nE	ゔぇ〆
n&/ko/nES	ゔぇ㉳
n&/ko/ni	ゔぇこ
n&/ko/nim	ゔぇㄶ
n&/ko/nin	ゔぇㅵ
n&/koS/t&n	ゔ㔉㍔
n&/kon	ゔけ
n&/kon/v&/li	ゔけ㈶も
n&/m&d	ゔ㈰
n&/m&k	ゔ㉷
n&/m&k/dun	ゔ㉷㙣
n&/ma/yE/SE	ゔ〖〤ㅠ
n&/ma/yE/SE/S&n	ゔ〖〤ㅠむ
n&/ma/yE/SE/to	ゔ〖〤ㅠ〙
n&/ma/yE/SE/tun	ゔ〖〤ㅠㄖ
n&/ma/yE/SES	ゔ〖〤㎀
n&/ma/yE/SEt	ゔ〖〤㕁
n&/ma/yE/Sa	ゔ〖〤〨
n&/ma/yE/Sa/tun	ゔ〖〤〨ㄖ
n&/ma/yE/Sa/yE	ゔ〖〤〨〤
n&/ma/yE/Si	ゔ〖〤げ
n&/ma/yE/Si/E	ゔ〖〤げ【
n&/ma/yE/Sin	ゔ〖〤゙
n&/ma/yE/Sin/Ga	ゔ〖〤゙〉
n&/ma/yES	ゔ〖㥒
n&/ma/yES/na/m&S/EG/ra	ゔ〖㥒〸㍧㝐ㅹ
n&/ma/yES/na/m&t	ゔ〖㥒〸㝡
n&/ma/yES/na/mE	ゔ〖㥒〸ㆂ
n&/ma/z&/mo	ゔ〖ㄥ㈓
n&/ma/zEt	ゔ〖㚄
n&/mal	ゔ㔹
n&/mi/ri	ゔ〃〵
n&/mor/dE	ゔ㌰あ
n&/mun/dE	ゔだあ
n&/mun/di	ゔだび
n&/mund	ゔ䀃
n&/n&S	ゔ㔸
n&/nE	ゔ〆
n&/nE/vES/t&m	ゔ〆㝨ㅨ
n&/nE/vES/tE	ゔ〆㝨つ
n&/nE/vis	ゔ〆䅓
n&/p&/rE	ゔㅆ〕
n&/p&r	ゔ㖐
n&/por/si/di	ゔ㉕々び
n&/por/si/di/xob	ゔ㉕々び〶
n&/pors	ゔ㝩
n&/pox/t&n	ゔ䉧㍔
n&/pox/tE	ゔ䉧つ
n&/pu/Si	ゔゆげ
n&/pu/Si/dE	ゔゆげあ
n&/puS	ゔ䄐
n&/r&8/sE	ゔ㐠〇
n&/r&8/si/di	ゔ㐠々び
n&/r&f/t&n	ゔ㉃㍔
n&/r&f/tE	ゔ㉃つ
n&/r&f/ti	ゔ㉃ㅔ
n&/r&ft	ゔす
n&/r&m	ゔ㄄
n&/r&n	ゔへ
n&/rE	ゔ〕
n&/rE/sE	ゔ〕〇
n&/rE/si/dE	ゔ〕々あ
n&/rE/si/dE/an/kum	ゔ〕々あ䉂䐐
n&/rE/si/dim	ゔ〕々㈖
n&/rE/sid	ゔ〕㘁
n&/rE/sund	ゔ〕䍠
n&/ri	ゔ〵
n&/ri/z&m	ゔ〵㑶
n&/ri/zE	ゔ〵ㄕ
n&/ri/zi	ゔ〵ㄵ
n&/rid	ゔ䁆
n&/rim	ゔㆅ
n&/rin	ゔㅃ
n&/rix/t&m	ゔ㍙ㅨ
n&/rix/tim	ゔ㍙㐩
n&/rixt	ゔ㍖
n&/riz	ゔㅣ
n&/ro	ゔ〹
n&/sax/tE	ゔ䄶つ
n&/t&/rE/ki	ゔㄒ〕〥
n&/t&/ra/SES	ゔㄒㅹ㎀
n&/t&r/s&m	ゔ〄㑷
n&/t&r/s&n	ゔ〄㐙
n&/t&r/si/d&m	ゔ〄々ㅕ
n&/t&rs	ゔ㈨
n&/ti/G&/r&m	ゔㅔ㆗㄄
n&/ti/GE/yE	ゔㅔ㌲〤
n&/ti/GE/yi	ゔㅔ㌲㆕
n&/ti/Ge	ゔㅔ㕕
n&/tond	ゔ䆙
n&/tu/nE	ゔㅡ〆
n&/tu/nEs/t&n	ゔㅡ㑄㍔
n&/tu/nEs/ti	ゔㅡ㑄ㅔ
n&/tu/nEs/tim	ゔㅡ㑄㐩
n&/tu/nEst	ゔㅡ㘉
n&/tu/ni	ゔㅡこ
n&/v&/S&m	ゔ㈶㆑
n&/v&/So	ゔ㈶〈
n&/v&/mo	ゔ㈶㈓
n&/v&/tun	ゔ㈶ㄖ
n&/v&d	ゔ䁀
n&/v&m	ゔ㦙
n&/vE/yE	ゔ㔈〤
n&/va	ゔゃ
n&/va/rE/SE	ゔゃ〕ㅠ
n&/va/rEt	ゔゃ㑣
n&/var	ゔ㘕
n&/x&/r&m	ゔ㆖㄄
n&/x&/ri/di	ゔ㆖〵び
n&/x&n/di/d&m	ゔぁびㅕ
n&/x&nd	ゔ㐅
n&/xE	ゔ㈙
n&/xES	ゔ㌃
n&/xa/b&m	ゔし㙢
n&/xa/bi/d&m	ゔしちㅕ
n&/xa/bi/dE	ゔしちあ
n&/xa/bi/di	ゔしちび
n&/xa/yE	ゔし〤
n&/xab	ゔ㑦
n&/xad	ゔえ
n&/xay	ゔㅙ
n&/xe/r&m	ゔゖ㄄
n&/xer	ゔ㝂
n&/xi	ゔ㌢
n&/xo/r&/no	ゔぷ㈀ㆈ
n&/xo/r&m	ゔぷ㄄
n&/xo/r&n	ゔぷへ
n&/xo/rE	ゔぷ〕
n&/xo/rE/dES	ゔぷ〕㈴
n&/xo/ri	ゔぷ〵
n&/xo/rin	ゔぷㅃ
n&/xor	ゔさ
n&/xor/d&/nES	ゔさ㄰㉳
n&/xor/d&m	ゔさㅕ
n&/xor/d&n	ゔさぱ
n&/xor/dE	ゔさあ
n&/xor/di	ゔさび
n&/xord	ゔ㐱
n&/xu/nE	ゔ㄃〆
n&/xu/nE/mun	ゔ㄃〆だ
n&/xun	ゔめ
n&/xun/d&m	ゔめㅕ
n&/xun/dE	ゔめあ
n&/xun/dim	ゔめ㈖
n&/xun/din	ゔめ㌒
n&/y&r	ゔ㔣
n&/ya	ゔㄈ
n&/ya/i	ゔㄈ〷
n&/ya/in	ゔㄈ。
n&/ya/m&/d&n	ゔㄈばぱ
n&/ya/m&/dE	ゔㄈばあ
n&/ya/m&d	ゔㄈ㈰
n&/ya/yi	ゔㄈ㆕
n&/yad	ゔ㉆
n&/yam	ゔ㉂
n&/yar	ゔ㆐
n&/yo/m&d	ゔ㊕㈰
n&/yo/vor/d&m	ゔ㊕㈕ㅕ
n&/yo/vord	ゔ㊕㙠
n&/yof/tE	ゔ㉶つ
n&/yof/tad	ゔ㉶㊘
n&/yof/ti	ゔ㉶ㅔ
n&/yu/m&/d&m	ゔ㜀ばㅕ
n&/yu/m&/d&n	ゔ㜀ばぱ
n&/yu/m&/dE	ゔ㜀ばあ
n&/yu/m&d	ゔ㜀㈰
n&/z&/d&m	ゔㄥㅕ
n&/z&/dE	ゔㄥあ
n&/z&/di	ゔㄥび
n&/z&/dim	ゔㄥ㈖
n&/z&/n&m	ゔㄥ〗
n&/z&/nE	ゔㄥ〆
n&/z&/ni	ゔㄥこ
n&/z&/nim	ゔㄥㄶ
n&/z&/nin	ゔㄥㅵ
n&/z&/r&m	ゔㄥ㄄
n&/z&/rE	ゔㄥ〕
n&/z&/rE/n&	ゔㄥ〕ゔ
n&/z&/rES	ゔㄥて
n&/z&/rEt	ゔㄥ㑣
n&/z&/ri	ゔㄥ〵
n&/z&d	ゔ㘙
n&/z&n	ゔ㊖
n&/z&r	ゔ㖑
n&/zE/rE	ゔㄕ〕
n&/za/r&m	ゔ㎇㄄
n&/za/rE	ゔ㎇〕
n&/za/ri	ゔ㎇〵
n&/za/rid	ゔ㎇䁆
n&/zaS/t&m	ゔっㅨ
n&/zaS/tE	ゔっつ
n&/zaS/ti	ゔっㅔ
n&/zaSt	ゔ㖔
n&/zar	ゔ〠
n&8/SE	䆅ㅠ
n&8/SE/hat	䆅ㅠ㕂
n&8/SE/yE	䆅ㅠ〤
n&8/Sa/yE	䆅〨〤
n&8/Si	䆅げ
n&8S	䔔
n&S	㔸
n&S/k&/nE	㔸ㅖ〆
n&S/k&s/tE	㔸㡈つ
n&S/kun/d&m	㔸㝅ㅕ
n&S/mor/di	㔸㌰び
n&S/n&/v&m	㔸ゔ㦙
n&S/na/sE	㔸〸〇
n&S/ni/d&m	㔸こㅕ
n&S/ni/dE	㔸こあ
n&dari	䘐
n&f	䉨
n&f/ti	䉨ㅔ
n&f/ti/ya	䉨ㅔㄈ
n&h/vE/yE	䞕㔈〤
n&kar&m	䝀
n&kon	䒅
n&mayES&m	䢆
n&n/da/zES	ふ〴ㄧ
n&n/dax/t&m	ふㅧㅨ
n&n/daz	ふ㑠
n&r/dE	㑆あ
n&r/dE/bum	㑆あ䈦
n&r/gE/sE	㑆ぴ〇
n&r/gEs	㑆㑇
n&r/mE	㑆ㆂ
n&r/ma/So	㑆〖〈
n&r/ma/ro	㑆〖〹
n&r/mi	㑆〃
n&rm	䐡
n&s/lE	㠤ぅ
n&s/ta	㠤ゅ
n&s/tad	㠤㊘
n&sb	䐂
n&x	䔉
n&x/SE	䔉ㅠ
n&xord&st	䙗
n&z/di/kE	㜵びㄢ
n&z/di/kE/Sun	㜵びㄢ㆒
n&z/di/kES	㜵び㌐
n&z/di/ki	㜵び〥
n&z/di/ki/yE	㜵び〥〤
n&z/di/ki/yast	㜵び〥㑔
n&z/dik	㜵㜶
n&z/dik/t&r	㜵㜶〄
nE/8ab	〆ㅅ
nE/Ga/tE	〆〉つ
nE/Ga/tE/Sun	〆〉つ㆒
nE/Ga/tES	〆〉㉩
nE/Ga/tEt	〆〉㕶
nE/Gad	〆䑠
nE/Gat	〆㠀
nE/S&s/t&m	〆㔃ㅨ
nE/S&s/t&n	〆㔃㍔
nE/S&s/tE	〆㔃つ
nE/S&s/ti	〆㔃ㅔ
nE/S&s/tim	〆㔃㐩
nE/S&s/tin	〆㔃㌥
nE/S&st	〆㖃
nE/SEs/t&/nES	〆㘸ㄒ㉳
nE/SEs/t&m	〆㘸ㅨ
nE/SEs/t&n	〆㘸㍔
nE/SEs/tE	〆㘸つ
nE/SEs/ti	〆㘸ㅔ
nE/SEst	〆䑵
nE/Sa/ni/yi	〆〨こ㆕
nE/San	〆㞙
nE/Su/nE/yi	〆㐤〆㆕
nE/Su/nEt	〆㐤ㄲ
nE/Su/ni/yaS	〆㐤こ㐸
nE/Sun	〆㆒
nE/ba/y&d	〆〱ㅦ
nE/g&/r&m	〆ㄠ㄄
nE/g&/rES	〆ㄠて
nE/g&/rEt	〆ㄠ㑣
nE/g&/ra/nE/S&m	〆ㄠㅹ〆㆑
nE/g&/ra/nE/tun	〆ㄠㅹ〆ㄖ
nE/g&/ra/ni	〆ㄠㅹこ
nE/g&/ra/nit	〆ㄠㅹ㡧
nE/g&/ran	〆ㄠ㔁
nE/g&h	〆㒕
nE/g&h/b&n	〆㒕㕲
nE/g&h/ban	〆㒕䁕
nE/g&r	〆㈥
nE/ga	〆㍡
nE/ga/Sun	〆㍡㆒
nE/ga/h&m	〆㍡〦
nE/ga/hi	〆㍡ょ
nE/gaS	〆㠅
nE/gah	〆㐗
nE/mE/dE	〆ㆂあ
nE/maz	〆倅
nE/mi/&r/zid	〆〃㡐䕨
nE/mi/S&m	〆〃㆑
nE/mi/S&n	〆〃む
nE/mi/SE	〆〃ㅠ
nE/mi/Si	〆〃げ
nE/mi/Si/nE	〆〃げ〆
nE/mi/Si/ni	〆〃げこ
nE/mi/Sim	〆〃㕥
nE/mi/So/d&m	〆〃〈ㅕ
nE/mi/Sod	〆〃㈵
nE/mi/b&/r&/mE/tun	〆〃〡㈀ㆂㄖ
nE/mi/b&/rE	〆〃〡〕
nE/mi/b&/ri/mE/Sun	〆〃〡〵ㆂ㆒
nE/mi/bi/n&n	〆〃ちふ
nE/mi/bi/nE	〆〃ち〆
nE/mi/bi/ni	〆〃ちこ
nE/mi/bi/nim	〆〃ちㄶ
nE/mi/c&s/bE	〆〃䄕】
nE/mi/c&s/pE	〆〃䄕ㄣ
nE/mi/c&s/pu/ni	〆〃䄕ゆこ
nE/mi/d&/h&m	〆〃㄰〦
nE/mi/d&m	〆〃ㅕ
nE/mi/d&n	〆〃ぱ
nE/mi/dE	〆〃あ
nE/mi/da/dim	〆〃〴㈖
nE/mi/da/din	〆〃〴㌒
nE/mi/daSt	〆〃㑑
nE/mi/dad	〆〃㙄
nE/mi/di	〆〃び
nE/mi/di/d&n	〆〃びぱ
nE/mi/dim	〆〃㈖
nE/mi/du/n&m	〆〃ㄩ〗
nE/mi/du/n&n	〆〃ㄩふ
nE/mi/du/nE	〆〃ㄩ〆
nE/mi/du/nEs/t&m	〆〃ㄩ㑄ㅨ
nE/mi/du/nEs/t&n	〆〃ㄩ㑄㍔
nE/mi/du/nEs/tE	〆〃ㄩ㑄つ
nE/mi/du/nEs/tim	〆〃ㄩ㑄㐩
nE/mi/du/nEst	〆〃ㄩ㘉
nE/mi/du/ni	〆〃ㄩこ
nE/mi/du/nim	〆〃ㄩㄶ
nE/mi/du/nin	〆〃ㄩㅵ
nE/mi/f&h/m&m	〆〃㔤㍲
nE/mi/f&h/mE	〆〃㔤ㆂ
nE/mi/f&h/mi/d&m	〆〃㔤〃ㅕ
nE/mi/f&h/mid	〆〃㔤㔥
nE/mi/g&m	〆〃㍑
nE/mi/g&n	〆〃㙡
nE/mi/g&r/din	〆〃㈥㌒
nE/mi/gE	〆〃ぴ
nE/mi/gi	〆〃ん
nE/mi/gi/r&m	〆〃ん㄄
nE/mi/gi/r&n	〆〃んへ
nE/mi/gi/rE	〆〃ん〕
nE/mi/k&/n&m	〆〃ㅖ〗
nE/mi/k&/nE	〆〃ㅖ〆
nE/mi/k&/ni	〆〃ㅖこ
nE/mi/k&r/d&m	〆〃㉲ㅕ
nE/mi/k&r/d&n	〆〃㉲ぱ
nE/mi/k&r/di	〆〃㉲び
nE/mi/k&rd	〆〃㈲
nE/mi/kE/S&m	〆〃ㄢ㆑
nE/mi/kE/SE	〆〃ㄢㅠ
nE/mi/kE/Si	〆〃ㄢげ
nE/mi/kE/Si/Sun	〆〃ㄢげ㆒
nE/mi/kE/Si/di	〆〃ㄢげび
nE/mi/ko/n&m	〆〃ぇ〗
nE/mi/ko/n&n	〆〃ぇふ
nE/mi/ko/nE	〆〃ぇ〆
nE/mi/ko/ni	〆〃ぇこ
nE/mi/ko/nim	〆〃ぇㄶ
nE/mi/ko/nin	〆〃ぇㅵ
nE/mi/mi/rE	〆〃〃〕
nE/mi/mu/nE	〆〃㉀〆
nE/mi/mu/ni	〆〃㉀こ
nE/mi/p&/rE	〆〃ㅆ〕
nE/mi/p&/zE	〆〃ㅆㄕ
nE/mi/p&/zi/r&n	〆〃ㅆㄵへ
nE/mi/r&f/t&n	〆〃㉃㍔
nE/mi/r&m	〆〃㄄
nE/mi/r&n	〆〃へ
nE/mi/rE	〆〃〕
nE/mi/rE/s&m	〆〃〕㑷
nE/mi/rE/sE	〆〃〕〇
nE/mi/rE/sid	〆〃〕㘁
nE/mi/ri	〆〃〵
nE/mi/ri/z&m	〆〃〵㑶
nE/mi/rim	〆〃ㆅ
nE/mi/sa/zE	〆〃㈆ㄕ
nE/mi/sa/zim	〆〃㈆㍓
nE/mi/su/zE	〆〃㐣ㄕ
nE/mi/su/zun/d&n	〆〃㐣㙂ぱ
nE/mi/t&/rE/kE	〆〃ㄒ〕ㄢ
nE/mi/t&r/s&m	〆〃〄㑷
nE/mi/t&r/s&n	〆〃〄㐙
nE/mi/t&r/sE	〆〃〄〇
nE/mi/t&r/si	〆〃〄々
nE/mi/t&r/sid	〆〃〄㘁
nE/mi/tu/n&m	〆〃ㅡ〗
nE/mi/tu/n&n	〆〃ㅡふ
nE/mi/tu/nE	〆〃ㅡ〆
nE/mi/tu/nE/con	〆〃ㅡ〆㐀
nE/mi/tu/nEs/t&m	〆〃ㅡ㑄ㅨ
nE/mi/tu/nEs/t&n	〆〃ㅡ㑄㍔
nE/mi/tu/nEs/tE	〆〃ㅡ㑄つ
nE/mi/tu/nEs/ti	〆〃ㅡ㑄ㅔ
nE/mi/tu/nEst	〆〃ㅡ㘉
nE/mi/tu/ni	〆〃ㅡこ
nE/mi/tu/nim	〆〃ㅡㄶ
nE/mi/tu/nin	〆〃ㅡㅵ
nE/mi/x&/rE	〆〃㆖〕
nE/mi/xa/bi/d&n	〆〃しちぱ
nE/mi/xa/rE	〆〃し〕
nE/mi/xad	〆〃え
nE/mi/xam	〆〃㎓
nE/mi/xan	〆〃ひ
nE/mi/xas/t&m	〆〃㑕ㅨ
nE/mi/xas/t&n	〆〃㑕㍔
nE/mi/xas/tE	〆〃㑕つ
nE/mi/xast	〆〃䀧
nE/mi/xay	〆〃ㅙ
nE/mi/xaym	〆〃㕸
nE/mi/xayn	〆〃䙕
nE/mi/xo/r&/mES	〆〃ぷ㈀㊒
nE/mi/xo/r&/nES	〆〃ぷ㈀㉳
nE/mi/xo/r&n	〆〃ぷへ
nE/mi/xo/rE	〆〃ぷ〕
nE/mi/xo/ri	〆〃ぷ〵
nE/mi/xo/rim	〆〃ぷㆅ
nE/mi/xo/rin	〆〃ぷㅃ
nE/mi/xor/diS	〆〃さ㦕
nE/mi/xord	〆〃㐱
nE/mi/xu/nE	〆〃㄃〆
nE/mi/xu/ni	〆〃㄃こ
nE/mi/xu/nin	〆〃㄃ㅵ
nE/mi/ya/r&m	〆〃ㄈ㄄
nE/mi/ya/rE	〆〃ㄈ〕
nE/mi/yad	〆〃㉆
nE/mi/yam	〆〃㉂
nE/mi/yan	〆〃㍷
nE/mi/yay	〆〃㌡
nE/mi/yaym	〆〃䒒
nE/mi/yof/tE	〆〃㉶つ
nE/mi/yu/m&/d&n	〆〃㜀ばぱ
nE/mi/yu/m&/dE	〆〃㜀ばあ
nE/mi/yu/m&d	〆〃㜀㈰
nE/mi/z&/d&n	〆〃ㄥぱ
nE/mi/z&/di	〆〃ㄥび
nE/mi/z&/n&m	〆〃ㄥ〗
nE/mi/z&/n&n	〆〃ㄥふ
nE/mi/z&/nE	〆〃ㄥ〆
nE/mi/z&/ni	〆〃ㄥこ
nE/mi/z&/nim	〆〃ㄥㄶ
nE/mi/z&/rE	〆〃ㄥ〕
nE/mi/z&/rin	〆〃ㄥㅃ
nE/mi/za/r&m	〆〃㎇㄄
nE/mi/za/r&n	〆〃㎇へ
nE/miS/n&/v&m	〆㍂ゔ㦙
nE/miS/n&/vE	〆㍂ゔ㔈
nE/miS/n&/vi	〆㍂ゔ㒇
nE/miS/na/s&/mES	〆㍂〸づ㊒
nE/miS/na/s&m	〆㍂〸㑷
nE/miS/na/si	〆㍂〸々
nE/miS/nid	〆㍂㙆
nE/mig/z&St	〆䑶㙕
nE/mis/tE	〆㝱つ
nE/nay	〆䅗
nE/vES/t&m	〆㝨ㅨ
nE/vES/t&n	〆㝨㍔
nE/vES/t&st	〆㝨䌕
nE/vES/tE	〆㝨つ
nE/vES/tE/ha	〆㝨つと
nE/vES/tE/ha/tE	〆㝨つとつ
nE/vES/tE/haS	〆㝨つ㉰
nE/vES/ti	〆㝨ㅔ
nE/vi/s&n/dE/yE	〆㒇㐙あ〤
nE/vi/sit	〆㒇㠵
nE8/tE	䤘つ
nEmidun&m	䍢
nEmik&nE	㥢
nEmixay	䑢
nEr/sE/ri	㌅〇〵
nEr/sE/riS	㌅〇㐢
nEr/sE/ris/kul	㌅〇㝖䑱
nEr/sEr/si	㌅䌁々
nEs/b&/tE/Sun	㑄〡つ㆒
nEs/b&t	㑄㡩
nEs/ka/f&/ro	㑄㐶ㅂ〹
nEs/ka/fE	㑄㐶㈷
nEs/v&m	㑄㦙
nEs/vE	㑄㔈
nEs/vE/S&/bi	㑄㔈㍸ち
nEs/vE/S&b	㑄㔈㎂
nEs/vE/S&n	㑄㔈む
nEs/vE/ha/Sun	㑄㔈と㆒
nEs/vES	㑄㝨
nEsv	䅆
nEvis	䚅
nEvis&m	䚄
na/8o/la	〸㖀〢
na/Gur	〸㥓
na/bE/kar	〸】㈣
na/bE/rES/tE/ha/So	〸】てつと〈
na/dal	〸䀦
na/g&/han	〸ㄠㅉ
na/go/na	〸い〸
na/ha/r&m	〸と㄄
na/ha/rE	〸と〕
na/ha/rE/Sun	〸と〕㆒
na/ha/rE/to	〸と〕〙
na/ha/rES	〸とて
na/ha/rEt	〸と㑣
na/ha/ro	〸と〹
na/har	〸㍃
na/kam	〸㝹
na/kar	〸㈣
na/lid	〸㥆
na/mE	〸ㆂ
na/mE/ha	〸ㆂと
na/mE/yE	〸ㆂ〤
na/mE/yi	〸ㆂ㆕
na/mEh/mu/ni	〸㍱㉀こ
na/mEt	〸㞗
na/mi	〸〃
na/mi/E	〸〃【
na/mo/r&/t&/bE	〸㈓㈀ㄒ】
na/na	〸〸
na/na/i	〸〸〷
na/na/i/yE	〸〸〷〤
na/na/na/na/i	〸〸〸〸〷
na/na/yE	〸〸〤
na/na/yES	〸〸㥒
na/na/zE	〸〸ㄕ
na/na/zi	〸〸ㄵ
na/na/zi/&n	〸〸ㄵㅐ
na/nay	〸䅗
na/p&/zir	〸ㅆ䄇
na/rE	〸〕
na/rES	〸て
na/rEn/Gi	〸㈩㌆
na/rEn/GiS	〸㈩㔖
na/rEnG	〸䅄
na/ra/h&/ti	〸ㅹㄱㅔ
na/ra/h&t	〸ㅹ㝢
na/ra/h&t/ko/n&n/dE	〸ㅹ㝢ぇふあ
na/t&/8&/lo/bi	〸ㄒㄷ㌳ち
na/ti	〸ㅔ
na/ti/yE	〸ㅔ〤
na/ting/h&m	〸䝥〦
na/ting/ha/m&m	〸䝥と㍲
na/ting/ham	〸䝥㜲
na/xo/n&/So	〸ぷゔ〈
na/xo/n&/mo	〸ぷゔ㈓
na/xo/n&/to	〸ぷゔ〙
na/xo/n&t	〸ぷ㒁
na/xo/nE	〸ぷ〆
na/xo/nE/So	〸ぷ〆〈
na/xo/nE/to	〸ぷ〆〙
na/xo/nEt	〸ぷㄲ
na/xo/na/yE	〸ぷ〸〤
na/xon	〸䊘
na/xu/n&m/n&	〸㄃〗ゔ
na/xu/ni	〸㄃こ
na/xun/Sur	〸め䂇
na/xun/gir	〸めㅱ
na/z&/ni/n&m	〸ㄥこ〗
na/z&/nin	〸ㄥㅵ
na/zE	〸ㄕ
na/zES	〸ㄧ
na/zEt	〸㚄
na/za/dam	〸㎇㊄
na/zi	〸ㄵ
na/zi/la	〸ㄵ〢
na/zok	〸䊁
nad/rE	倁〕
nad/ram	倁㒀
nal	㤡
nanaz	㐇
nay	䅗
nay/lo/nE	䅗㌳〆
nay/lon	䅗㒂
nay/nay	䅗䅗
naz	㘲
naz/na/zi	㘲〸ㄵ
ne	㤐
ni	こ
ni/S&m	こ㆑
ni/SEt	こ㕁
ni/ki	こ〥
ni/ko/lE	こぇぅ
ni/kol	こ䑑
ni/lu/f&/rE	こぢㅂ〕
ni/lu/f&r	こぢ㊔
ni/m&st	こ䍱
ni/mE	こㆂ
ni/mE/yE	こㆂ〤
ni/mi/x&/ri	こ〃㆖〵
ni/mi/xam	こ〃㎓
ni/mo	こ㈓
ni/ni	ここ
ni/ni/y&/ro	ここ㍗〹
ni/ni/yE	ここ〤
ni/no	こㆈ
ni/ru/aS	こㄹ㒈
ni/vE/ha	こ㔈と
ni/yaz	こ㐰
niS	㊇
nim	ㄶ
nim/G&/v&/bi	ㄶ㆗㈶ち
nim/cE	ㄶで
nim/ru	ㄶㄹ
nin/tEn/do	ㅵ䁔〰
nin/tEn/dot	ㅵ䁔㥁
nis/t&m	㎅ㅨ
nis/t&n	㎅㍔
nis/tES	㎅㉩
nis/ti	㎅ㅔ
nis/tim	㎅㐩
nis/tin	㎅㌥
nist	㈡
no	ㆈ
no/E	ㆈ【
no/b&/t&m	ㆈ〡ㅨ
no/b&/tE	ㆈ〡つ
no/b&/tES	ㆈ〡㉩
no/b&/tEt	ㆈ〡㕶
no/b&/ti	ㆈ〡ㅔ
no/b&t	ㆈ㡩
no/hE	ㆈご
no/hom	ㆈ䒘
no/i	ㆈ〷
no/kE	ㆈㄢ
no/kES	ㆈ㌐
no/ruz	ㆈ㈐
no/tE	ㆈつ
no/xo/dES	ㆈぷ㈴
no/xo/da/So	ㆈぷ〴〈
no/xo/di	ㆈぷび
no/xod	ㆈ㙐
no/za/dE	ㆈ㎇あ
no8/lE	㕙ぅ
no8/li	㕙も
no8/li/yE	㕙も〤
no8l	㖄
noc	䠷
noh	㤘
noh/s&d	㤘㞄
nok	㙒
nok/t&/la/yi	㙒ㄒ〢㆕
nok/t&/la/yi/yE	㙒ㄒ〢㆕〤
nok/t&/ro	㙒ㄒ〹
nok/tE/yE	㙒つ〤
nokES	䝓
nos/r&t	㤶㡓
nox/tE/ha	䁵つと
nox/tE/ha/So	䁵つと〈
nox/tE/nox/tE/yi	䁵つ䁵つ㆕
nox/tE/v&s/li/koni	䁵つ䍷も䘠
noxodci	䙧
nu/SE	ㄳㅠ
nu/Sa/b&S	ㄳ〨㤀
nu/Sa/b&t	ㄳ〨㡩
nu/Sa/bE	ㄳ〨】
nu/Sa/bE/hE	ㄳ〨】ご
nu/Si/d&/ni	ㄳげ㄰こ
nu/Si/d&/ni/yE	ㄳげ㄰こ〤
nu/nE	ㄳ〆
nu/nES	ㄳ㉳
nu/na	ㄳ〸
nu/ni	ㄳこ
nu/no	ㄳㆈ
nuSid&ni	䜦
nun	㞈
nun/a/rEn/Gi	㞈〧㈩㌆
nun/p&/ni/rES	㞈ㅆこて
nun/p&/nir	㞈ㅆ㤇
nun/so/xa/ri	㞈ㅇし〵
nun/va/yi	㞈ゃ㆕
nun/va/yi/E/mo/va/zEb	㞈ゃ㆕【㈓ゃ㝒
nunz/d&/ho/mE	䈴㄰㌱ㆂ
nunz/d&h	䈴㉈
nunz/d&h/xob	䈴㉈〶
nur	䐖
o	㈔
o/E	㈔【
o/S&/tE	㈔㍸つ
o/an/kum	㈔䉂䐐
o/b&/8i/E/yE	㈔〡㌶【〤
o/b&/lE	㈔〡ぅ
o/b&d	㈔㄂
o/ba/ma	㈔〱〖
o/cul	㈔䡃
o/gof/t&m	㈔ㅳㅨ
o/goft	㈔ㅷ
o/han	㈔ㅉ
o/la/do	㈔〢〰
o/lad	㈔䍴
o/m&/d&m	㈔ばㅕ
o/m&/d&n	㈔ばぱ
o/m&/dEh	㈔ば䕶
o/m&/di	㈔ばび
o/m&d	㈔㈰
o/mid	㈔㔥
o/mid/va/r&m	㈔㔥ゃ㄄
o/mu/mi	㈔㉀〃
o/na	㈔〸
o/ta/8&/kE	㈔ゅㄷㄢ
o/ta/8&/ki	㈔ゅㄷ〥
o/ta/8&m	㈔ゅㅶ
o/ta/8E	㈔ゅ㊁
o/ta/8E/mun	㈔ゅ㊁だ
o/ta/8ES	㈔ゅ㚗
o/ta/8Et	㈔ゅ㚑
o/ta/8a	㈔ゅぃ
o/ta/8a/tun	㈔ゅぃㄖ
o/ta/8i	㈔ゅ㌶
o/ta8	㈔㕦
o/ta8/xab	㈔㕦㑦
o/to	㈔〙
o/to/bu/sE	㈔〙ら〇
o/to/bu/sE/Sun	㈔〙ら〇㆒
o/to/bu/sa	㈔〙ら㈆
o/to/bus	㈔〙㐧
o/tu/bu/sE	㈔ㅡら〇
o/v&8/ti	㈔㉣ㅔ
o/va8t	㈔䤐
o/vor/d&m	㈔㈕ㅕ
o/vor/d&n	㈔㈕ぱ
o/vor/dE	㈔㈕あ
o/vor/dES	㈔㈕㈴
o/vor/di	㈔㈕び
o/vor/dim	㈔㈕㈖
o/vor/din	㈔㈕㌒
o/vord	㈔㙠
o/xa/li	㈔しも
o/yE	㈔〤
o/za	㈔㎇
o/za/yE	㈔㎇〤
of/ta/d&/n&/gE	㊗ゅ㄰ゔぴ
of/ta/d&m	㊗ゅㅕ
of/ta/d&n	㊗ゅぱ
of/ta/dE	㊗ゅあ
of/ta/di	㊗ゅび
of/ta/din	㊗ゅ㌒
of/tad	㊗㊘
oftadi	䥠
oh	㥑
om	㙉
om&di	䦁
om/r&m	㙉㄄
om/r&n	㙉へ
om/rE	㙉〕
om/va/nE	㙉ゃ〆
omr	䠤
on/to/ri/y&m	䥂〙〵㥹
or/d&/kE	䀕㄰ㄢ
or/d&k	䀕䄢
or/di/bE/hESt	䀕び】䘥
or/dovr	䀕䅲
or/fEt	䀕䀱
org	䚈
os	㉑
os/tE/xan/haS	㉑つひ㉰
os/tE/xu/nE	㉑つ㄃〆
os/tE/xu/nE/to	㉑つ㄃〆〙
os/to/va/ri	㉑〙ゃ〵
os/to/va/ri/yE	㉑〙ゃ〵〤
os/to/xu/naS	㉑〙㄃㉒
os/to/xun	㉑〙め
ota8E	䥱
ox	ㅗ
oy	䌢
p&/Gu/hES/g&r	ㅆ㄀ㆇ㈥
p&/SE/du/ni	ㅆㅠㄩこ
p&/Si/mu/nE/Sun	ㅆげ㉀〆㆒
p&/Si/mu/ni	ㅆげ㉀こ
p&/Si/mun	ㅆげだ
p&/l&/kE	ㅆ㌧ㄢ
p&/l&N	ㅆ㕅
p&/la	ㅆ〢
p&/lu	ㅆぢ
p&/lu/E	ㅆぢ【
p&/lu/yE	ㅆぢ〤
p&/luS	ㅆ㔄
p&/lut	ㅆ㦒
p&/nah	ㅆ䞓
p&/nah/gah	ㅆ䞓㐗
p&/ni/rE	ㅆこ〕
p&/ni/rES	ㅆこて
p&/ni/rEt	ㅆこ㑣
p&/ni/ra/SE	ㅆこㅹㅠ
p&/ni/ra/ro	ㅆこㅹ〹
p&/ni/ro	ㅆこ〹
p&/nir	ㅆ㤇
p&/p&/yi	ㅆㅆ㆕
p&/r&n/d&/ro	ㅆへ㄰〹
p&/r&n/d&n	ㅆへぱ
p&/r&n/d&st	ㅆへ㎑
p&/r&n/dE	ㅆへあ
p&/r&n/dE/hE	ㅆへあご
p&/r&n/dE/ha	ㅆへあと
p&/r&n/dE/ha/ro	ㅆへあと〹
p&/r&n/dE/hi	ㅆへあょ
p&/r&n/dE/yE	ㅆへあ〤
p&/r&ns	ㅆ䐙
p&/r&s/ta/rE	ㅆ䁒ゅ〕
p&/r&s/ta/ri	ㅆ䁒ゅ〵
p&/r&s/tu	ㅆ䁒ㅡ
p&/rE/SE	ㅆ〕ㅠ
p&/rES	ㅆて
p&/ra/k&n/d&n	ㅆㅹ㔩ぱ
p&/ri	ㅆ〵
p&/ri/dE	ㅆ〵あ
p&/ri/di	ㅆ〵び
p&/ri/ha	ㅆ〵と
p&/ri/naz	ㅆ〵㘲
p&/ri/ruz	ㅆ〵㈐
p&/ri/sa	ㅆ〵㈆
p&/ri/sam	ㅆ〵㡑
p&/ri/v&S	ㅆ〵䅥
p&/ri/yan	ㅆ〵㍷
p&/rid	ㅆ䁆
p&/s&/gE	ㅆづぴ
p&/tu	ㅆㅡ
p&/tu/to	ㅆㅡ〙
p&/ya/mE/nur	ㅆㄈㆂ䐖
p&/yam/b&r	ㅆ㉂㈤
p&/yin	ㅆ㊓
p&/zE	ㅆㄕ
p&/zi/ra/yi/E	ㅆㄵㅹ㆕【
p&/zi/rof/tE	ㅆㄵ䝸つ
p&S/m&/ki	㘃ば〥
p&S/ma/lu	㘃〖ぢ
p&S/ma/luS	㘃〖㔄
p&S/mi	㘃〃
p&h/l&/va/nE	㌈㌧ゃ〆
p&h/l&/van	㌈㌧㥗
p&h/lu/yE	㌈ぢ〤
p&h/nE	㌈〆
p&h/nES	㌈㉳
p&hn	䙉
p&n/GE	㒖㌲
p&n/GE/r&st	㒖㌲㞅
p&n/GE/rE	㒖㌲〕
p&n/GE/rE/ha	㒖㌲〕と
p&n/GE/rE/yi	㒖㌲〕㆕
p&n/GE/yE	㒖㌲〤
p&n/Ga	㒖〉
p&n/Ga/hE	㒖〉ご
p&n/Ga/ta	㒖〉ゅ
p&n/Gim	㒖㠶
p&n/Go	㒖㒗
p&n/Gom	㒖䐃
p&n/Gu/lE	㒖㄀ぅ
p&n/gu/&n	㒖〒ㅐ
p&nG	㑰
p&nG/S&n/b&st	㑰む㙖
p&nG/S&n/bE	㑰む】
p&nG/ta	㑰ゅ
p&nG/taS	㑰㐵
p&nG/tast	㑰㍁
p&nS/ta	䦀ゅ
p&r	㖐
p&r/b&s/tE	㖐㐐つ
p&r/c&/mE	㖐㙈ㆂ
p&r/c&m	㖐䁢
p&r/dE	㖐あ
p&r/dE/ha	㖐あと
p&r/dE/ha/yE	㖐あと〤
p&r/dE/yE/ba	㖐あ〤〱
p&r/tE	㖐つ
p&r/tES	㖐㉩
p&r/ta/bES	㖐ゅ㌕
p&r/tab	㖐㕄
p&r/ti	㖐ㅔ
p&r/va/n&/ro	㖐ゃゔ〹
p&r/va/nE	㖐ゃ〆
p&r/va/nE/i/E	㖐ゃ〆〷【
p&r/va/rES/ga/hE	㖐ゃて㍡ご
p&r/va/zi	㖐ゃㄵ
p&r/vaz	㖐㝵
p&r/vi/no	㖐㒇ㆈ
p&r/vin	㖐䉔
p&r/z&/ni/yE	㖐ㄥこ〤
p&rt	㜤
p&rtkon&st	䁧
p&rtkonE	䁨
p&s	ㄴ
p&s/ba/ba/yE	ㄴ〱〱〤
p&x/SE	䢄ㅠ
p&xS	䅤
pE	ㄣ
pE/d&/r&m	ㄣ㄰㄄
pE/d&/rE	ㄣ㄰〕
pE/d&/rE/Sun	ㄣ㄰〕㆒
pE/d&/rES	ㄣ㄰て
pE/d&r	ㄣㆉ
pE/d&r/bo/zor/gE	ㄣㆉぶ㌙ぴ
pE/d&r/bo/zorg	ㄣㆉぶ㈈
pE/d&r/tak	ㄣㆉ㠩
pE/ga/hE	ㄣ㍡ご
pE/i/a/no/ro	ㄣ〷〧ㆈ〹
pE/i/yE	ㄣ〷〤
pE/l&m	ㄣㆄ
pE/lE	ㄣぅ
pE/lE/ha	ㄣぅと
pE/lE/ha/yE	ㄣぅと〤
pE/la/is/t&/i/SEn	ㄣ〢やㄒ〷㜄
pE/la/kE	ㄣ〢ㄢ
pE/la/kE/tun	ㄣ〢ㄢㄖ
pE/las/ti/ki	ㄣ㔢ㅔ〥
pE/las/ti/ki/ya	ㄣ㔢ㅔ〥ㄈ
pE/li/kan	ㄣも㜴
pE/ni/si/lin	ㄣこ々ㄤ
pE/r&ns	ㄣ䐙
pE/s&/r&m	ㄣづ㄄
pE/s&/r&n	ㄣづへ
pE/s&/rE	ㄣづ〕
pE/s&/rES	ㄣづて
pE/s&/ra	ㄣづㅹ
pE/s&/ri	ㄣづ〵
pE/s&/ru/nE	ㄣづㄹ〆
pE/s&r	ㄣ㎙
pE/s&r/xa/l&t	ㄣ㎙し㜥
pE/zES/ki	ㄣㄧ〥
pE/zES/kit	ㄣㄧ䡤
pEG/man	㉁〩
pESt	䒗
pEc/pE/cE	䘇ㄣで
pEl	㖕
pEl/ka/So	㖕㐶〈
pEn/ha/ni	䐩とこ
pEn/han	䐩ㅉ
pEs/tu/n&k	䁓ㅡ㑐
pEs/tu/na/kE/So	䁓ㅡ〸ㄢ〈
pa	〘
pa/E/i	〘【〷
pa/Er	〘㝰
pa/Er/gErl/zi	〘㝰㠳ㄵ
pa/Sid	〘ざ
pa/Sim	〘㕥
pa/Sin	〘゙
pa/So	〘〈
pa/So/di	〘〈び
pa/Sun	〘㆒
pa/cE	〘で
pa/dE/Sa	〘あ〨
pa/dE/Sa/h&m	〘あ〨〦
pa/dE/Sa/hE	〘あ〨ご
pa/dE/Sa/ha/yE	〘あ〨と〤
pa/dE/Sa/yE	〘あ〨〤
pa/dE/Sa/yi	〘あ〨㆕
pa/da/rES	〘〴て
pa/ha/S&m	〘と㆑
pa/ha/mun	〘とだ
pa/ha/to	〘と〙
pa/ha/tun	〘とㄖ
pa/ha/yE	〘と〤
pa/haS	〘㉰
pa/hat	〘㕂
pa/i	〘〷
pa/i/nE	〘〷〆
pa/i/nES	〘〷㉳
pa/i/na/rE	〘〷〸〕
pa/i/ni	〘〷こ
pa/i/yE	〘〷〤
pa/i/zE	〘〷ㄕ
pa/in	〘。
pa/in/t&r	〘。〄
pa/iz	〘䢉
pa/k&m	〘㉘
pa/kE	〘ㄢ
pa/kES	〘㌐
pa/kEt	〘㊑
pa/ki/zE	〘〥ㄕ
pa/ko/nES	〘ぇ㉳
pa/kon	〘け
pa/lE/in	〘ぅ。
pa/laN	〘䦅
pa/mo	〘㈓
pa/mun	〘だ
pa/rE	〘〕
pa/ri	〘〵
pa/ri/d&n	〘〵ぱ
pa/sE	〘〇
pa/sa/Ga/yi	〘㈆〉㆕
pa/sa/rE	〘㈆〕
pa/so	〘ㅇ
pa/t&m	〘ㅨ
pa/ti	〘ㅔ
pa/to	〘〙
pa/y&S	〘㌷
pa/yE	〘〤
pa/yE/haS	〘〤㉰
pa/yE/in	〘〤。
pa/yE/yE	〘〤〤
pa/yan	〘㍷
pa/yi	〘㆕
pa/yi/nE	〘㆕〆
pa/yi/nES	〘㆕㉳
pa/yi/na/rum	〘㆕〸䂀
pa/yin	〘㊓
pa/zE/lE	〘ㄕぅ
pa/zE/lE/S&m	〘ㄕぅ㆑
pa/zE/lE/to	〘ㄕぅ〙
pa/zE/lEt	〘ㄕ㆔
pa/zE/la	〘ㄕ〢
pa/zE/la/ro	〘ㄕ〢〹
pa/zE/la/yE	〘ㄕ〢〤
pa/zE/la/yi	〘ㄕ〢㆕
pa/zE/laS	〘ㄕ㜗
pa/zE/lat	〘ㄕ㑹
pa/zE/li/E	〘ㄕも【
pa/zEl	〘㔰
paS	㕉
paS/nE/yE	㕉〆〤
pag/vars	䑈䑉
pak	㘦
pam	㙸
pam/ki/nE	㙸〥〆
pan/sE/man	䚁〇〩
panz/d&/hom	䙙㄰䒘
par/c&/ro	㥡㙈〹
par/c&S	㥡䍲
par/cE	㥡で
par/cE/yi	㥡で㆕
par/kE	㥡ㄢ
par/kiN	㥡䀹
par/ko	㥡ぇ
par/sa	㥡㈆
par/sa/yE	㥡㈆〤
par/sal	㥡㈇
park	㥱
part	䕵
pas	㑵
pas/f&r/da	㑵㊔〴
pas/ti/la	㑵ㅔ〢
pas/til	㑵㠒
pat	㤂
patEr&m	䑄
paz	䥓
pe/8am	㈁㙷
pe/da	㈁〴
pe/daS	㈁㈂
pen	䄔
pi	ㄉ
pi/Es/pi	ㄉ㈸ㄉ
pi/SE	ㄉㅠ
pi/SE/&m	ㄉㅠ〓
pi/SE/Sun	ㄉㅠ㆒
pi/SE/ma	ㄉㅠ〖
pi/SE/mun	ㄉㅠだ
pi/SEt	ㄉ㕁
pi/Sa/ma/dE/gi	ㄉ〨〖あん
pi/Si	ㄉげ
pi/Su/niS	ㄉ㐤㊇
pi/caS	ㄉ䠗
pi/ci/d&S	ㄉぉ㥄
pi/ci/di	ㄉぉび
pi/cid	ㄉ䄷
pi/nE/du/zE	ㄉ〆ㄩㄕ
pi/nE/duz	ㄉ〆㍄
pi/pi	ㄉㄉ
pi/pi/E	ㄉㄉ【
pi/pit	ㄉ㑖
pi/r&m	ㄉ㄄
pi/r&n	ㄉへ
pi/rE	ㄉ〕
pi/rE/m&r/dE	ㄉ〕㚀あ
pi/ra/h&/nE	ㄉㅹㄱ〆
pi/raS/ki	ㄉㄐ〥
pi/raS/ki/ha	ㄉㄐ〥と
pi/raS/ki/yE	ㄉㄐ〥〤
pi/riS	ㄉ㐢
pi/ruz	ㄉ㈐
pi/ya/d&S	ㄉㄈ㥄
pi/ya/dE	ㄉㄈあ
pi/ya/dE/r&/vi	ㄉㄈあ㈀㒇
pi/ya/dEt	ㄉㄈ㈃
pi/ya/no	ㄉㄈㆈ
pi/yaz	ㄉ㐰
piN	䂒
piN/poN	䂒䂓
piS	㞁
piS/8&/za	㞁ㄷ㎇
piS/b&nd	㞁㍆
piS/n&/ha/dE	㞁ゔとあ
piS/n&/ha/di	㞁ゔとび
piS/n&/ha/di/yE	㞁ゔとび〤
piS/n&/had	㞁ゔ䑳
piS/n&/har	㞁ゔ㍃
piS/p&r/daxt	㞁㖐㙅
piS/r&f/tE	㞁㉃つ
piS/r&f/tE/tun	㞁㉃つㄖ
piS/r&ft	㞁す
piS/xob	㞁〶
pic	㤣
pig/lEt	䖘㆔
pis/tE	䠩つ
pit/ka/mi/pit/ka/mi/yE	㑖㐶〃㑖㐶〃〤
pit/sa	㑖㈆
pit/sa/yE	㑖㈆〤
pit/sat	㑖㝔
ple	㜂
ple/has	㜂䄒
ple/ste/SEn	㜂䀲㜄
po/f&/ka	べㅂ㐶
po/f&k	べ㒃
po/l&/ro	べ㌧〹
po/lE	べぅ
po/li/sE	べも〇
po/li/sa	べも㈆
po/lis	べ㢀
po/lo	べ㌳
po/lo/E	べ㌳【
po/lo/S&m	べ㌳㆑
po/lo/p&z	べ㌳㒉
po/lo/to	べ㌳〙
po/loS	べ䕹
po/lom	べ㤩
po/lot	べ㒙
po/r&N	べ䉑
po/r&n/gE	べへぴ
po/rE	べ〕
po/ro/fE/sor	べ〹㈷㡀
po/rost	べぐ
po/ru	べㄹ
po/tEr	べ㞀
po/to/8al	べ〙㒄
poS/t&/mE	㖉ㄒㆂ
poS/t&/rE	㖉ㄒ〕
poS/tE	㖉つ
poS/tE/SE	㖉つㅠ
poS/tE/Sun	㖉つ㆒
poS/tE/bum	㖉つ䈦
poS/tE/ru	㖉つㄹ
poS/tE/tE	㖉つつ
poS/tES	㖉㉩
poS/tEt	㖉㕶
poSt	㠐
poSt/c&sp/dar	㠐䂃㐑
pof	䔒
pol	㘳
por	㉕
por/G&/va/hEr	㉕㆗ゃ䘱
por/si	㉕々
por/si/d&m	㉕々ㅕ
por/si/dE	㉕々あ
por/si/di	㉕々び
por/sid	㉕㘁
por/tE/8a/la	㉕つぃ〢
por/tE/8al	㉕つ㒄
por/to/8a/la	㉕〙ぃ〢
por/to/8al	㉕〙㒄
pos/tE/ra/yE	䜶つㅹ〤
post/ci	䅔ぉ
post/xu/nE	䅔㄃〆
pox/t&/nES	䉧ㄒ㉳
pox/t&n	䉧㍔
pox/t&n/mi/r&m	䉧㍔〃㄄
pox/tE	䉧つ
pox/ti	䉧ㅔ
poxt	䈂
pr&ns	䎁
pro/Ge/yE	䌸㕕〤
pu/S&/k&m	ゆ㍸㉘
pu/S&/kE/Sun	ゆ㍸ㄢ㆒
pu/S&/kES	ゆ㍸㌐
pu/S&k	ゆ㜨
pu/Sa/kE/S&m	ゆ〨ㄢ㆑
pu/Si/d&m	ゆげㅕ
pu/Si/d&z	ゆげ䒖
pu/Si/dE	ゆげあ
pu/Si/di	ゆげび
pu/Sid	ゆざ
pu/Sun/dE	ゆ㆒あ
pu/kE	ゆㄢ
pu/l&/ki	ゆ㌧〥
pu/lE	ゆぅ
pu/lE/tun	ゆぅㄖ
pu/lEt	ゆ㆔
pu/la/yE	ゆ〢〤
pu/li	ゆも
pu/pu	ゆゆ
pu/pum	ゆ䄈
pu/r&N	ゆ䉑
pu/r&t	ゆ㡓
pu/rE	ゆ〕
pu/rE/ha/yE	ゆ〕と〤
pu/ya	ゆㄈ
pu/zE/lE	ゆㄕぅ
pu/zE/lE/to	ゆㄕぅ〙
pu/zEl	ゆ㔰
puS&k	㤕
pud/rE	䙠〕
pudr	䅱
pul	㥂
pul&tiyE	㡠
pul/dar	㥂㐑
pun/s&d	䅷㞄
punz/d&/hE	䆄㄰ご
punz/d&/hom	䆄㄰䒘
punz/d&h	䆄㉈
punz/d&h/ta	䆄㉈ゅ
pus/tE	䔱つ
pus/tE/SE	䔱つㅠ
pus/tES	䔱㉩
pus/tEr	䔱㞀
pus/tEt	䔱㕶
pust	䍗
r&/8i/bim	㈀㌶䀣
r&/bi/tE	㈀ちつ
r&/bit	㈀䄧
r&/di/fE	㈀び㈷
r&/di/n&m	㈀び〗
r&/di/nE	㈀び〆
r&/di/no	㈀びㆈ
r&/din	㈀㌒
r&/fi/8&m	㈀㉥ㅶ
r&/fi/8a/yE	㈀㉥ぃ〤
r&/fi/8aS	㈀㉥䡷
r&/fi8	㈀䈰
r&/ha	㈀と
r&/ha/yE	㈀と〤
r&/i	㈀〷
r&/i/s&m	㈀〷㑷
r&/i/sE	㈀〷〇
r&/i/sES	㈀〷㐃
r&/is	㈀や
r&/kE/tE	㈀ㄢつ
r&/kE/tEt	㈀ㄢ㕶
r&/kEt	㈀㊑
r&/ki	㈀〥
r&/mE	㈀ㆂ
r&/na/mi/zi/Sun	㈀〸〃ㄵ㆒
r&/sa/yi/E	㈀㈆㆕【
r&/vE/SE	㈀㔈ㅠ
r&/vE/Sa/yE	㈀㔈〨〤
r&/vES	㈀㝨
r&/vES/ha/yE	㈀㝨と〤
r&/va/bE/tE/mun	㈀ゃ】つだ
r&/van	㈀㥗
r&/van/xa/ni	㈀㥗しこ
r&8/sE	㐠〇
r&8/si	㐠々
r&8/si/d&n	㐠々ぱ
r&8/si/di	㐠々び
r&8/sid	㐠㘁
r&8s	㔆
r&N	䉑
r&b/ti	䆇ㅔ
r&bt	䢅
r&d	㤨
r&d/if	㤨䌵
r&f/t&m	㉃ㅨ
r&f/t&n	㉃㍔
r&f/tE	㉃つ
r&f/tE/gi	㉃つん
r&f/tE/xob	㉃つ〶
r&f/tES	㉃㉩
r&f/tar	㉃䂙
r&f/ti	㉃ㅔ
r&f/tim	㉃㐩
r&f/tin	㉃㌥
r&ft	す
r&ft/c&nd	す㈅
r&ftim	䥨
r&g	䆗
r&g/ba/rE	䆗〱〕
r&h/b&/ra	䂁〡ㅹ
r&h/b&/ra/mun	䂁〡ㅹだ
r&h/b&r	䂁㈤
r&h/n&/ma	䂁ゔ〖
r&hm	䊇
r&m	㄄
r&n/dE	へあ
r&n/dE/gi	へあん
r&n/gE	へぴ
r&n/gE/Sun	へぴ㆒
r&n/gES	へ㐔
r&n/gES/kE	へ㐔ㄢ
r&n/ga	へ㍡
r&n/ga/S&m	へ㍡㆑
r&n/ga/So	へ㍡〈
r&n/ga/r&ng	へ㍡㘂
r&n/ga/yE	へ㍡〤
r&n/ga/yi	へ㍡㆕
r&n/gaS	へ㠅
r&n/gat	へ䐁
r&n/gi	へん
r&n/gi/E	へん【
r&n/gi/r&n/gi	へんへん
r&n/gi/yE	へん〤
r&n/gi/yat	へん㥶
r&n/gin	へ㜩
r&n/gin/k&/man	へ㜩ㅖ〩
r&n/gin/k&/mu/ni	へ㜩ㅖ㉀こ
r&n/go/va/r&n/gES	へいゃへ㐔
r&ng/ha/yE	㘂と〤
r&ng/ri/zi	㘂〵ㄵ
r&ng/va/r&/N&n	㘂ゃ㈀㜔
r&x/tE/xa/bE/to	㉸つし】〙
r&x/tE/xa/bE/tu/no	㉸つし】ㅡㆈ
r&x/tE/xab	㉸つ㑦
r&x/ta	㉸ゅ
r&xS	䘢
r&xt	㊈
r&xtExabayE	䡦
rE	〕
rE/GE	〕㌲
rE/fi/8&m	〕㉥ㅶ
rE/fi/8aS	〕㉥䡷
rE/kor/dE	〕䁖あ
rE/kor/dEt	〕䁖㈃
rE/la	〕〢
rE/pun/zE/lES	〕䅷ㄕ㈱
rE/pun/zEl	〕䅷㔰
rE/si	〕々
rE/si/d&m	〕々ㅕ
rE/si/d&n	〕々ぱ
rE/si/dE	〕々あ
rE/si/dE/gi	〕々あん
rE/si/dE/yE	〕々あ〤
rE/si/di	〕々び
rE/si/dim	〕々㈖
rE/si/din	〕々㌒
rE/sid	〕㘁
rE/sund	〕䍠
rE/za/va/ni	〕㎇ゃこ
rEd	㠈
rEf/tE	㌤つ
rEs/to/ra/nE	㚕〙ㅹ〆
rEs/to/ran	㚕〙㔁
rEt	㑣
rEx/ti	䥧ㅔ
rEz/va/ni	䁸ゃこ
rEz/va/ni/yE	䁸ゃこ〤
rEza	䚙
ra	ㅹ
ra/GE/bE	ㅹ㌲】
ra/GE/bE/Sun	ㅹ㌲】㆒
ra/GE/bES	ㅹ㌲㌕
ra/Sun	ㅹ㆒
ra/bE/tE	ㅹ】つ
ra/bi	ㅹち
ra/bin/hu/dE	ㅹ぀㌨あ
ra/bin/hud	ㅹ぀䎂
ra/bin/son	ㅹ぀㠖
ra/di/yo	ㅹび㊕
ra/gof/ti	ㅹㅳㅔ
ra/h&/t&/rE	ㅹㄱㄒ〕
ra/h&/t&r	ㅹㄱ〄
ra/h&/tE	ㅹㄱつ
ra/h&/ti	ㅹㄱㅔ
ra/h&/tun	ㅹㄱㄖ
ra/h&n	ㅹ㐈
ra/h&t	ㅹ㝢
ra/hE	ㅹご
ra/hES	ㅹㆇ
ra/hi	ㅹょ
ra/la/ki	ㅹ〢〥
ra/mi/na	ㅹ〃〸
ra/mi/nast	ㅹ〃䄁
ra/min	ㅹ㉴
ra/n&n/d&/ro	ㅹふ㄰〹
ra/n&n/d&st	ㅹふ㎑
ra/n&n/dE	ㅹふあ
ra/n&n/dE/gi	ㅹふあん
ra/n&n/dE/giS	ㅹふあ䊀
ra/n&n/dE/gim	ㅹふあㆆ
ra/n&n/dE/hE	ㅹふあご
ra/n&n/dE/ha	ㅹふあと
ra/n&n/dE/ha/yE	ㅹふあと〤
ra/n&n/dE/yE	ㅹふあ〤
ra/yan	ㅹ㍷
ra/z&n	ㅹ㊖
ra/zE	ㅹㄕ
ra/zES	ㅹㄧ
ra/zi	ㅹㄵ
raS	ㄐ
rah	㥅
rah/n&/ma	㥅ゔ〖
rah/n&/ma/yi	㥅ゔ〖㆕
rah/n&/ma/yiS	㥅ゔ〖㞔
rah/pE/lE	㥅ㄣぅ
rah/ra/hES	㥅ㅹㆇ
rah/ro	㥅〹
rah/z&/na	㥅ㄥ〸
rah/z&n	㥅㊖
ran/d&n/dE	㔁ぱあ
ran/d&n/dE/gi	㔁ぱあん
ras	㍇
ras/tE	㍇つ
ras/tE/S&/ma	㍇つ㍸〖
ras/tE/So	㍇つ〈
ras/tES	㍇㉩
ras/ti	㍇ㅔ
rast	㈠
re/ka	㚅㐶
res/to/ra/nES	䁰〙ㅹ㉳
ri/SE	〵ㅠ
ri/SES	〵㎀
ri/Su/E	〵㐤【
ri/yE	〵〤
ri/ya/s&t	〵ㄈ㞂
ri/z&m	〵㑶
ri/zE	〵ㄕ
ri/zE/mun	〵ㄕだ
ri/zE/pi/z&st	〵ㄕㄉㄙ
ri/zi	〵ㄵ
riS	㐢
rin/ging	ㅃ䔃
rix/t&/nE	㍙ㄒ〆
rix/t&m	㍙ㅨ
rix/t&n	㍙㍔
rix/tE	㍙つ
rix/tES	㍙㉩
rix/tEt	㍙㕶
rix/ti	㍙ㅔ
rix/tim	㍙㐩
rix/tin	㍙㌥
rixt	㍖
riz	ㅣ
riz/ri/zi/y&n	ㅣ〵ㄵ䀸
riz/riz	ㅣㅣ
rizriz	䑔
ro	〹
ro/8&/nE	〹ㄷ〆
ro/8&n	〹㚉
ro/8&n/ha/yE	〹㚉と〤
ro/8&n/ze/tun	〹㚉䉉ㄖ
ro/S&/nE	〹㍸〆
ro/S&/nES	〹㍸㉳
ro/S&n	〹む
ro/Sa	〹〨
ro/bE	〹】
ro/ba	〹〱
ro/ba/hE	〹〱ご
ro/ba/tE	〹〱つ
ro/ba/ta	〹〱ゅ
ro/h&/viG	〹ㄱ䁶
ro/la/E	〹〢【
ro/mi/du/ni	〹〃ㄩこ
ro/mi/na	〹〃〸
ro/n&	〹ゔ
ro/pa	〹〘
ro/s&/rE	〹づ〕
ro/sa	〹㈆
ro/san	〹䍘
ro/xEt	〹䕆
ro/xa	〹し
ro/ya/hast	〹ㄈ㠁
ro/z&/kE	〹ㄥㄢ
ro/z&k	〹㕤
roS/tE	㥃つ
rob	㍶
ros/t&/mi	㉨ㄒ〃
ros/t&/mo	㉨ㄒ㈓
ros/t&m	㉨ㅨ
ru	ㄹ
ru/&n	ㄹㅐ
ru/E	ㄹ【
ru/Sun	ㄹ㆒
ru/b&d	ㄹ㄂
ru/b&nd	ㄹ㍆
ru/ba/h&/ro	ㄹ〱ㄱ〹
ru/ba/hE	ㄹ〱ご
ru/ba/ha	ㄹ〱と
ru/ba/hi	ㄹ〱ょ
ru/bah	ㄹ㢖
ru/dE	ㄹあ
ru/dE/haS	ㄹあ㉰
ru/hE	ㄹご
ru/ha	ㄹと
ru/i	ㄹ〷
ru/iS	ㄹ䆉
ru/mi/nu	ㄹ〃ㄳ
ru/mi/zi	ㄹ〃ㄵ
ru/mi/zi/yE	ㄹ〃ㄵ〤
ru/no	ㄹㆈ
ru/s&/ri	ㄹづ〵
ru/s&/ri/So	ㄹづ〵〈
ru/s&/ri/mo	ㄹづ〵㈓
ru/s&/ri/to	ㄹづ〵〙
ru/s&/ri/yE	ㄹづ〵〤
ru/tun	ㄹㄖ
ru/xob	ㄹ〶
ru/yE	ㄹ〤
ru/yE/xob	ㄹ〤〶
ru/yi	ㄹ㆕
ru/zE	ㄹㄕ
ru/zE/Sun	ㄹㄕ㆒
ru/zES	ㄹㄧ
ru/za	ㄹ㎇
ru/za/yE	ㄹ㎇〤
ru/za/yi	ㄹ㎇㆕
ru/zam	ㄹ䒔
ru/zi	ㄹㄵ
ru/zo	ㄹ㝉
ruS	ㅰ
ruS/ba/zi/g&/ra/yE	ㅰ〱ㄵㄠㅹ〤
rud/xu/nE	䜨㄃〆
ruh	䕲
ruh/b&x/SEt	䕲㊙㕁
ruh/b&xS	䕲䕳
ruh/z&/dE	䕲ㄥあ
ruhm	䠥
rum	䂀
rus/ta	㖁ゅ
rus/ta/yE	㖁ゅ〤
rut	㢉
ruz	㈐
ruz/na/mE/yE	㈐〸ㆂ〤
ruz/na/mE/yi	㈐〸ㆂ㆕
s&/8&n/8ur	づ㚉㊀
s&/8&n/gur	づ㚉䜒
s&/a/d&/ti	づ〧㄰ㅔ
s&/b&/dE	づ〡あ
s&/b&/dE/tE	づ〡あつ
s&/b&/dE/tun	づ〡あㄖ
s&/b&/dEt	づ〡㈃
s&/b&/di	づ〡び
s&/b&d	づ㄂
s&/d&f	づ㤧
s&/f&/rE	づㅂ〕
s&/f&/rE/mun	づㅂ〕だ
s&/f&/rE/tun	づㅂ〕ㄖ
s&/f&/ro	づㅂ〹
s&/f&S	づ䀁
s&/f&r	づ㊔
s&/fE	づ㈷
s&/fE/haS	づ㈷㉰
s&/fE/yE	づ㈷〤
s&/fEt	づ䀱
s&/fa	づ㕈
s&/g&/ro	づㄠ〹
s&/g&n/gur	づ㙡䜒
s&/gE	づぴ
s&/gES	づ㐔
s&/gi	づん
s&/h&r	づ㈄
s&/i	づ〷
s&/i/do	づ〷〰
s&/id	づ䅉
s&/l&m	づㆄ
s&/l&m/8ur	づㆄ㊀
s&/l&n/8ur	づ㍕㊀
s&/lE/dE	づぅあ
s&/lE/da/yE	づぅ〴〤
s&/lEd	づ䠲
s&/la/m&/le/kom	づ〢ば㑢㡒
s&/la/m&/lek	づ〢ば䔅
s&/la/m&/ti/Sun	づ〢ばㅔ㆒
s&/la/m&t	づ〢㝡
s&/la/mE	づ〢ㆂ
s&/la/mi	づ〢〃
s&/lam	づ㎔
s&/m&/kE/tun	づばㄢㄖ
s&/m&/kES	づば㌐
s&/m&/kEt	づば㊑
s&/m&k	づ㉷
s&/ma/v&r	づ〖㍉
s&/mi/mi/&m	づ〃〃〓
s&/mu/r&n	づ㉀へ
s&/mu/sE	づ㉀〇
s&/n&/i	づゔ〷
s&/n&/vi/&t	づゔ㒇㉤
s&/r&m	づ㄄
s&/rE	づ〕
s&/rE/SE	づ〕ㅠ
s&/rE/So	づ〕〈
s&/rE/Sun	づ〕㆒
s&/rE/ha/l&m	づ〕とㆄ
s&/rE/mun	づ〕だ
s&/rE/tE	づ〕つ
s&/rE/to	づ〕〙
s&/rE/tun	づ〕ㄖ
s&/rES	づて
s&/rEt	づ㑣
s&/ri	づ〵
s&/rim	づㆅ
s&/ro	づ〹
s&/tar/xan	づ䂙ひ
s&/va/r&s/l&n	づゃ䁒㍕
s&/va/rES	づゃて
s&/va/re	づゃ㚅
s&/va/ri	づゃ〵
s&/var	づ㘕
s&/yE	づ〤
s&/yE/mun	づ〤だ
s&b	㐹
s&b/rEt	㐹㑣
s&b/ri/na	㐹〵〸
s&b/ri/nast	㐹〵䄁
s&b/zE	㐹ㄕ
s&b/zE/ha	㐹ㄕと
s&b/zEt	㐹㚄
s&b/za	㐹㎇
s&b/zaS	㐹っ
s&b/zat	㐹㠱
s&b/zi	㐹ㄵ
s&b/zi/E	㐹ㄵ【
s&b/zi/po/lo	㐹ㄵべ㌳
s&br	ㅈ
s&bz	㍦
s&bz/xurd/ko/ni/ya	㍦㌖ぇこㄈ
s&d	㞄
s&d/ta	㞄ゅ
s&f	㤈
s&g	㠧
s&h/nE	䘲〆
s&h/nE/yE	䘲〆〤
s&h/nE/yE/xa/lE	䘲〆〤しぅ
s&m/t&n/cE	㑷㍔で
s&m/tE	㑷つ
s&m/tES	㑷㉩
s&n/Ga/ba	㐙〉〱
s&n/Ga/bi/yast	㐙〉ち㑔
s&n/Gab	㐙䝠
s&n/bad	㐙㑉
s&n/d&/lE	㐙㄰ぅ
s&n/d&/li	㐙㄰も
s&n/d&/li/E	㐙㄰も【
s&n/d&/lim	㐙㄰䜰
s&n/d&/lit	㐙㄰㕨
s&n/do/8&/8&/bE	㐙〰ㄷㄷ】
s&n/do/8i	㐙〰㌶
s&n/g&/ki/yE	㐙ㄠ〥〤
s&n/g&k	㐙䉴
s&n/gi/nE	㐙ん〆
s&n/gin	㐙㜩
s&nd/vi/ci	䉸㒇ぉ
s&ng/ri/zES	䠃〵ㄧ
s&r	㎙
s&r/ba/z&m	㎙〱㑶
s&r/ba/zE	㎙〱ㄕ
s&r/ba/za	㎙〱㎇
s&r/ba/za/nE	㎙〱㎇〆
s&r/ba/za/yE	㎙〱㎇〤
s&r/baz	㎙㐉
s&r/dE	㎙あ
s&r/dE/tE	㎙あつ
s&r/dES	㎙㈴
s&r/dEt	㎙㈃
s&r/fE/Gu/i	㎙㈷㄀〷
s&r/g&r/mi/yE	㎙㈥〃〤
s&r/ma	㎙〖
s&r/ma/xor/dE/git	㎙〖さあ䌃
s&r/s&bz	㎙㍦
s&r/sE/da	㎙〇〴
s&r/z&/mi/nE	㎙ㄥ〃〆
s&r/za/d&m	㎙㎇ㅕ
s&r/zad	㎙㦁
s&rd	㑁
s&rma	䖖
s&t/lE/tun	㞂ぅㄖ
s&tl	㠷
s&var	䞈
s&var&n	䞉
s&variyE	䠰
s&x/fE	㌓㈷
s&x/fES	㌓㘶
s&x/mi	㌓〃
s&x/t&/rE	㌓ㄒ〕
s&x/t&/ri/nES	㌓ㄒ〵㉳
s&x/t&/ri/no	㌓ㄒ〵ㆈ
s&x/t&/rin	㌓ㄒㅃ
s&x/t&/ro	㌓ㄒ〹
s&x/t&r	㌓〄
s&x/tE	㌓つ
s&x/ta	㌓ゅ
s&x/ti	㌓ㅔ
s&x/ti/E	㌓ㅔ【
s&x/tiyE	㌓䔳
s&xt	㌗
s&xt/pust	㌗䍗
sE	〇
sE/S&n/b&/r&m	〇む〡㄄
sE/S&n/bE	〇む】
sE/da	〇〴
sE/da/So	〇〴〈
sE/da/ha	〇〴と
sE/da/ha/Sun	〇〴と㆒
sE/da/tun	〇〴ㄖ
sE/da/yE	〇〴〤
sE/da/yi	〇〴㆕
sE/da/yi/E	〇〴㆕【
sE/daS	〇㈂
sE/dam	〇㊄
sE/dat	〇㚃
sE/fa/rE/S&/gE	〇㕈〕㍸ぴ
sE/fa/rE/SE	〇㕈〕ㅠ
sE/fa/rE/Si	〇㕈〕げ
sE/fa/rES	〇㕈て
sE/fi/d&/ro	〇㉥㄰〹
sE/fi/d&k	〇㉥䄢
sE/fi/d&m	〇㉥ㅕ
sE/fi/dE	〇㉥あ
sE/fi/di	〇㉥び
sE/fi/do	〇㉥〰
sE/fid	〇䁑
sE/hE/zar	〇ご〠
sE/i/va	〇〷ゃ
sE/i/vat	〇〷䆖
sE/iv	〇䈁
sE/kE/yE	〇ㄢ〤
sE/n&/f&/ri	〇ゔㅂ〵
sE/p&/rEt	〇ㅆ㑣
sE/pEhr	〇䁂
sE/pid	〇㘧
sE/ri	〇〵
sE/ri/ya/lE	〇〵ㄈぅ
sE/ri/ya/li	〇〵ㄈも
sE/ri/yi	〇〵㆕
sE/ta	〇ゅ
sE/ta/ba/8E	〇ゅ〱㊁
sE/ta/r&st	〇ゅ㞅
sE/ta/rE	〇ゅ〕
sE/ta/rE/ha	〇ゅ〕と
sE/ta/rE/ha/yE	〇ゅ〕と〤
sE/ta/rE/ha/yi	〇ゅ〕と㆕
sE/ta/rE/yE	〇ゅ〕〤
sE/ta/rE/yi	〇ゅ〕㆕
sE/ta/ro	〇ゅ〹
sE/ta/yi/mun	〇ゅ㆕だ
sE/taS	〇㐵
sE/tast	〇㍁
sE/vo/mE	〇㖆ㆂ
sE/vo/mi/S&m	〇㖆〃㆑
sE/vo/min	〇㖆㉴
sE/vom	〇䅁
sE/ya	〇ㄈ
sE/ya/hE	〇ㄈご
sEb/8&t	䈠㍴
sEf/t&/rE	㕡ㄒ〕
sEf/tE	㕡つ
sEf/tES	㕡㉩
sEf/ti	㕡ㅔ
sEfr	㡲
sEft	㉔
sEh	䌒
sEh/ra/miz	䌒ㅹ㈗
sEk/sE/k&t	䑹〇㍢
sEn	䄤
sEn/tE	䄤つ
sEn/ti/mEt/ri	䄤ㅔ㞗〵
sEn/ti/pi	䄤ㅔㄉ
sEn/ti/pi/ti	䄤ㅔㄉㅔ
sEn/ti/pi/ti/yE	䄤ㅔㄉㅔ〤
sEr/vi/sE	䌁㒇〇
sEr/vi/sa/yE	䌁㒇㈆〤
sEr/vis/ha/yE	䌁䅓と〤
sErc	䕣
sErf	㈦
sEst	㥨
sa/&/t&m	㈆ㅀㅨ
sa/&/tE	㈆ㅀつ
sa/&/tES	㈆ㅀ㉩
sa/&/ti	㈆ㅀㅔ
sa/&/to	㈆ㅀ〙
sa/&t	㈆㉤
sa/&t/E	㈆㉤【
sa/&t/ha/yi	㈆㉤と㆕
sa/8&r	㈆㑅
sa/E/to	㈆【〙
sa/bE/tE	㈆】つ
sa/bEt	㈆㐥
sa/bi	㈆ち
sa/bu/ni	㈆らこ
sa/bun	㈆㘗
sa/dE/gi	㈆あん
sa/dE/t&/rES	㈆あㄒて
sa/dE/yi	㈆あ㆕
sa/hE/bE	㈆ご】
sa/hE/bE/Si	㈆ご】げ
sa/hE/bES	㈆ご㌕
sa/hE/lES	㈆ご㈱
sa/hEb	㈆䝂
sa/hEl	㈆䘕
sa/i	㈆〷
sa/i/E	㈆〷【
sa/it	㈆㒔
sa/kE	㈆ㄢ
sa/kEt	㈆㊑
sa/l&S	㈆㝓
sa/l&m	㈆ㆄ
sa/lE	㈆ぅ
sa/lE/SE	㈆ぅㅠ
sa/lE/gim	㈆ぅㆆ
sa/lE/mE	㈆ぅㆂ
sa/lE/n&	㈆ぅゔ
sa/lE/tE	㈆ぅつ
sa/lE/tu/nE	㈆ぅㅡ〆
sa/la/yE	㈆〢〤
sa/li	㈆も
sa/lo/nE	㈆㌳〆
sa/lon	㈆㒂
sa/ni/E	㈆こ【
sa/ra	㈆ㅹ
sa/ram	㈆㒀
sa/ro	㈆〹
sa/va/rES	㈆ゃて
sa/var	㈆㘕
sa/yE/hE	㈆〤ご
sa/yi	㈆㆕
sa/zEt	㈆㚄
sa/zad	㈆㦁
sab	䁤
saks	㢁
sal	㈇
sal/da/ri/E	㈇〴〵【
sam/bE/li/b&/lE/i/kom	㡑】も〡ぅ〷㡒
san/dE/vi/cE	䍘あ㒇で
san/dE/vi/cEt	䍘あ㒇䙐
san/dE/vic	䍘あ䐣
sand/vi/ci	䉷㒇ぉ
sant	䞀
sax/t&/nE/mun	䄶ㄒ〆だ
sax/t&m	䄶ㅨ
sax/t&n	䄶㍔
sax/t&n/xob	䄶㍔〶
sax/tE	䄶つ
sax/tE/mu/n&m	䄶つ㉀〗
sax/tE/mu/nE	䄶つ㉀〆
sax/tE/mu/nES	䄶つ㉀㉳
sax/tE/mu/na	䄶つ㉀〸
sax/tE/mun	䄶つだ
sax/ti	䄶ㅔ
saxt	㜢
saz	䔑
sel	䡂
si	々
si/E	々【
si/b&m	々㙢
si/bE	々】
si/bES	々㌕
si/ba	々〱
si/bi/l&/mo	々ち㌧㈓
si/bi/lu	々ちぢ
si/bi/yE	々ち〤
si/bil	々㢔
si/bo	々ぶ
si/di	々び
si/di/E	々び【
si/di/a	々び〧
si/di/ya/yi	々びㄈ㆕
si/diS	々㦕
si/dim	々㈖
si/mE	々ㆂ
si/ma/ni	々〖こ
si/man	々〩
si/mo	々㈓
si/mor8	々㤔
si/n&/ma	々ゔ〖
si/n&/mat	々ゔ䈱
si/n&t	々㒁
si/rES	々て
si/rab/Sir/dun	々㌔㊃㙣
si/ri	々〵
si/ro	々〹
si/s&d	々㞄
si/sE	々〇
si/sa/ro	々㈆〹
si/ti	々ㅔ
si/ti/yE	々ㅔ〤
si/xE	々㈙
si/ya	々ㄈ
si/ya/E	々ㄈ【
si/ya/hE	々ㄈご
si/ya/i	々ㄈ〷
si/ya/pust	々ㄈ䍗
si/yah	々䍕
sib	䁷
sib/z&/mi/ni	䁷ㄥ〃こ
sib/z&/mi/ni/ha/ro	䁷ㄥ〃こと〹
sib/z&/mi/ni/ha/yE	䁷ㄥ〃こと〤
sib/z&/mi/ni/yE	䁷ㄥ〃こ〤
sib/z&/mi/ni/yo	䁷ㄥ〃こ㊕
sib/z&/mi/niS	䁷ㄥ〃㊇
sin/dE/rE/la	㔗あ〕〢
sir	㘒
sirk	㌵
siz/d&/hE	㤷㄰ご
siz/d&/hom	㤷㄰䒘
siz/d&/hu/m&/d&m	㤷㄰㌨ばㅕ
siz/d&h	㤷㉈
sket	㢓
sket/bord	㢓㈳
sko/lEt	䥷㆔
skul	䥉
so/&l	ㅇ㠆
so/a/l&m	ㅇ〧ㆄ
so/a/lE	ㅇ〧ぅ
so/a/li	ㅇ〧も
so/al	ㅇ䒂
so/ba	ㅇ〱
so/ba/ha/nE	ㅇ〱と〆
so/ba/nE	ㅇ〱〆
so/bat	ㅇ㐡
so/bo/nE	ㅇぶ〆
so/bu/n&t	ㅇら㒁
so/bu/nE	ㅇら〆
so/dE	ㅇあ
so/ma/yE	ㅇ〖〤
so/ma/yE/ro	ㅇ〖〤〹
so/r&/tE	ㅇ㈀つ
so/r&/tEt	ㅇ㈀㕶
so/r&t	ㅇ㡓
so/ra/8E	ㅇㅹ㊁
so/ra/8ES	ㅇㅹ㚗
so/ruS	ㅇㅰ
so/s&/ro	ㅇづ〹
so/s&m	ㅇ㑷
so/sE	ㅇ〇
so/sa	ㅇ㈆
so/sa/So	ㅇ㈆〈
so/sa/yE	ㅇ㈆〤
so/si	ㅇ々
so/si/si	ㅇ々々
so/sis	ㅇ㝘
so/so/rE	ㅇㅇ〕
so/x&n/gu	ㅇぁ〒
so/x&n/gu/yE	ㅇぁ〒〤
so/x&n/gu/yi	ㅇぁ〒㆕
so/x&n/ra/ni	ㅇぁㅹこ
so/xa/ri	ㅇし〵
sob	㐨
sob/hE	㐨ご
sob/ha	㐨と
sob/ha/n&/ro	㐨とゔ〹
sob/ha/nE	㐨と〆
sob/ha/nE/yE	㐨と〆〤
sob/han	㐨ㅉ
sob/ho/nE	㐨㌱〆
sob/hu/n&t	㐨㌨㒁
sob/hu/nE	㐨㌨〆
sob/hu/nE/yE	㐨㌨〆〤
sobh	㐲
sod	倂
sof/r&/ro	䂂㈀〹
sof/r&/tun	䂂㈀ㄖ
sof/rE	䂂〕
soh/b&/tEt	㡨〡㕶
soh/b&/ta	㡨〡ゅ
soh/b&/ta/yE	㡨〡ゅ〤
soh/b&/ti	㡨〡ㅔ
soh/b&t	㡨㡩
sol	䝃
sol/ta/nE	䝃ゅ〆
sol/tan	䝃㎖
sor	㡀
sor/fE	㡀㈷
sor/fE/ha/mun	㡀㈷とだ
sor/fE/yi	㡀㈷㆕
sor/so/r&S	㡀ㅇ㡢
sor/so/rE	㡀ㅇ〕
sor/xES	㡀㌃
sor/xa/bi	㡀しち
sor/xi	㡀㌢
sorx	㝙
sorx/bo/ro	㝙ぶ〹
sorx/pus/ta	㝙䔱ゅ
sos	㑸
sost/dE/r&xt	䢃あ㊈
spa/ro	䌳〹
spun	䅠
stra/ik	㦄㦅
su	㐣
su/G&S	㐣㦑
su/an	㐣䉂
su/pE	㐣ㄣ
su/pEr	㐣㞘
su/pEr/m&n	㐣㞘㄁
su/pi	㐣ㄉ
su/r&/t&m	㐣㈀ㅨ
su/r&/tE	㐣㈀つ
su/r&/tE/tE	㐣㈀つつ
su/r&/tE/to	㐣㈀つ〙
su/r&/tES	㐣㈀㉩
su/r&/tEt	㐣㈀㕶
su/r&/ti	㐣㈀ㅔ
su/r&/ti/E	㐣㈀ㅔ【
su/r&/ti/yE	㐣㈀ㅔ〤
su/r&/tiS	㐣㈀㝶
su/r&/to	㐣㈀〙
su/r&t	㐣㡓
su/ra/xE	㐣ㅹ㈙
su/ra/xES	㐣ㅹ㌃
su/ra/xa	㐣ㅹし
su/ra/xa/Sun	㐣ㅹし㆒
su/ra/xa/yE	㐣ㅹし〤
su/rax	㐣䉣
su/sul	㐣䊂
su/tu/nE	㐣ㅡ〆
su/xa/ri	㐣し〵
su/z&n	㐣㊖
su/zun/d&n	㐣㙂ぱ
sud	㘈
sup	㚂
surax	䐴
sus/k&/ro	䀒ㅖ〹
sus/kE	䀒ㄢ
sus/ma/r&/ro	䀒〖㈀〹
sus/ma/rE/cE	䀒〖〕で
sus/ma/ra	䀒〖ㅹ
sus/mar	䀒㉧
susk	䌑
sut	䥄
sux/t&m	䀐ㅨ
sux/tE	䀐つ
sux/tES	䀐㉩
suxt	䀉
suxtE	䂅
t&/8&/lob	ㄒㄷ䕅
t&/8i/ra/ti	ㄒ㌶ㅹㅔ
t&/8ir	ㄒ䚕
t&/Go/ba/v&/ri/yE	ㄒ㒗〱㈶〵〤
t&/Gob	ㄒ䀷
t&/Gob/z&/dE	ㄒ䀷ㄥあ
t&/S&/kor	ㄒ㍸䁖
t&/b&/8&/ro	ㄒ〡ㄷ〹
t&/b&/8E	ㄒ〡㊁
t&/b&/8E/yE	ㄒ〡㊁〤
t&/bi/y&t	ㄒち㉦
t&/bi/yi/yE	ㄒち㆕〤
t&/dig	ㄒ㡤
t&/h&/mo/lE	ㄒㄱ㈓ぅ
t&/h&/mol	ㄒㄱ䖆
t&/hE	ㄒご
t&/hES	ㄒㆇ
t&/hi/y&S	ㄒょ㌷
t&/in	ㄒ。
t&/ki	ㄒ〥
t&/ku/nES	ㄒ㉗㉳
t&/ku/na	ㄒ㉗〸
t&/kun	ㄒ㝅
t&/lE	ㄒぅ
t&/la	ㄒ〢
t&/la/E	ㄒ〢【
t&/la/SEt	ㄒ〢㕁
t&/la/Sa/yE	ㄒ〢〨〤
t&/la/fiS	ㄒ〢䅣
t&/la/foz	ㄒ〢䊅
t&/la/yi	ㄒ〢㆕
t&/la/yi/yE	ㄒ〢㆕〤
t&/laS	ㄒ㜗
t&/mE	ㄒㆂ
t&/mES/kE	ㄒ㊒ㄢ
t&/ma/Sa	ㄒ〖〨
t&/ma/Sa/ci	ㄒ〖〨ぉ
t&/ma/Sa/ci/ya	ㄒ〖〨ぉㄈ
t&/ma/Sa/ci/yast	ㄒ〖〨ぉ㑔
t&/ma/Sa/xa/nE	ㄒ〖〨し〆
t&/ma/mE	ㄒ〖ㆂ
t&/mam	ㄒ㥖
t&/mas	ㄒ䄴
t&/mi	ㄒ〃
t&/mi/z&m	ㄒ〃㑶
t&/mi/zE	ㄒ〃ㄕ
t&/mi/zES	ㄒ〃ㄧ
t&/mi/zi	ㄒ〃ㄵ
t&/mir	ㄒ㑈
t&/mir/ka/ra	ㄒ㑈㐶ㅹ
t&/miz	ㄒ㈗
t&/miz/t&/rE	ㄒ㈗ㄒ〕
t&/miz/xu/bE	ㄒ㈗㄃】
t&/mu/mE	ㄒ㉀ㆂ
t&/mu/mES	ㄒ㉀㊒
t&/mum	ㄒ㌣
t&/nE/Su/nE	ㄒ〆㐤〆
t&/nES	ㄒ㉳
t&/nEt	ㄒㄲ
t&/na/b&m	ㄒ〸㙢
t&/na/bE	ㄒ〸】
t&/na/bEt	ㄒ〸㐥
t&/na/so/bi	ㄒ〸ㅇち
t&/na/sob	ㄒ〸㐨
t&/nab	ㄒ䄹
t&/pE	ㄒㄣ
t&/r&/fE	ㄒ㈀㈷
t&/r&/fES	ㄒ㈀㘶
t&/r&/fa	ㄒ㈀㕈
t&/r&/fa/yE	ㄒ㈀㕈〤
t&/r&/fo	ㄒ㈀㎆
t&/r&f	ㄒ㉃
t&/r&f/da/rE	ㄒ㉃〴〕
t&/r&f/da/rES	ㄒ㉃〴て
t&/r&k	ㄒ䖔
t&/ra/hE	ㄒㅹご
t&/ra/hi	ㄒㅹょ
t&/ra/hi/yE	ㄒㅹょ〤
t&/ri/fES	ㄒ〵㘶
t&/rif	ㄒ㘔
t&/rok	ㄒ䈙
t&/s&/vor	ㄒづ㈕
t&/sa/dof	ㄒ㈆䙹
t&/si	ㄒ々
t&/ti/lE	ㄒㅔぅ
t&/til	ㄒ㠒
t&/v&/Go	ㄒ㈶㒗
t&/v&/lo/dE	ㄒ㈶㌳あ
t&/v&/lo/dE/SE	ㄒ㈶㌳あㅠ
t&/v&/lo/dE/So	ㄒ㈶㌳あ〈
t&/v&/lo/dE/Sun	ㄒ㈶㌳あ㆒
t&/v&/lo/dE/to	ㄒ㈶㌳あ〙
t&/v&/lo/dES	ㄒ㈶㌳㈴
t&/v&/lod	ㄒ㈶㥦
t&/va/na/yi/a/yE	ㄒゃ〸㆕〧〤
t&/vi/lE	ㄒ㒇ぅ
t&/x&/yo/li	ㄒ㆖㊕も
t&/za/ho/rat	ㄒ㎇㌱ㄦ
t&/zin	ㄒ䖐
t&8	㌀
t&8/ri/b&n	㌀〵㕲
t&8/si/mES	㌀々㊒
t&8/si/rE	㌀々〕
t&8/zi/yE	㌀ㄵ〤
t&G/riS	䕤㐢
t&N	㚆
t&S/vi/8E	㚖㒇㊁
t&S/vi/8ES	㚖㒇㚗
t&S/vi8	㚖㜣
t&S/xis	㚖㐴
t&St	䕑
t&b	㕵
t&b/dil	㕵䐲
t&b/li/8E	㕵も㊁
t&b/li/8a	㕵もぃ
t&b/li/8a/yE	㕵もぃ〤
t&b/li8	㕵䉰
t&b/rik	㕵䁗
t&f/ri/hi	䞄〵ょ
t&f/rih	䞄䞅
t&h	㌂
t&h/8i8	㌂䐕
t&h/di/dEt	㌂び㈃
t&h/did	㌂㌦
t&h/m&/zE	㌂ばㄕ
t&h/m&/zE/yE	㌂ばㄕ〤
t&k	㘹
t&k/li/fEt	㘹も䀱
t&k/lif	㘹㙦
t&k/mil	㘹䞇
t&k/si	㘹々
t&k/t&/kE/Sun	㘹ㄒㄢ㆒
t&l/xE	㘣㈙
t&l/xi	㘣㌢
t&lx	䉡
t&m	ㅨ
t&m/b&/lE	ㅨ〡ぅ
t&m/b&/la	ㅨ〡〢
t&m/b&/li	ㅨ〡も
t&m/ri/nE	ㅨ〵〆
t&m/rin	ㅨㅃ
t&n	㍔
t&n/b&/li	㍔〡も
t&n/b&l	㍔㝣
t&n/b&l/xa/num	㍔㝣しじ
t&n/ha	㍔と
t&n/ha/yi	㍔と㆕
t&n/ham	㍔㜲
t&n/zim	㍔㍓
t&nk	䆐
t&nz	䀖
t&p	㤆
t&r	〄
t&r/Gi	〄㌆
t&r/Gih	〄䜠
t&r/Go/m&S	〄㒗㍧
t&r/hES	〄ㆇ
t&r/ki/bES	〄〥㌕
t&r/ki/baS	〄〥㐓
t&r/sE	〄〇
t&r/si/d&m	〄々ㅕ
t&r/si/dE	〄々あ
t&r/si/di	〄々び
t&r/sid	〄㘁
t&r/su	〄㐣
t&r/su/yi	〄㐣㆕
t&r/sun	〄㡄
t&r/sun/d&/nE	〄㡄㄰〆
t&r/zE	〄ㄕ
t&rh	䕰
t&rk	䡴
t&rs	㈨
t&rs/na/kE	㈨〸ㄢ
t&rs/na/kES	㈨〸㌐
t&rs/nak	㈨㢕
t&rs/nak/t&/ri/nE	㈨㢕ㄒ〵〆
t&s/mi/mE	䐱〃ㆂ
t&s/mi/ma/yE	䐱〃〖〤
t&s/mim	䐱㜓
t&v&/Go/yE	䘦㒗〤
t&v/lo/dEt	䦆㌳㈃
t&v/lod	䦆㥦
t&x/fi/fi	㆙㉥㉥
t&x/fif	㆙䂐
t&x/t&m	㆙ㅨ
t&x/tE	㆙つ
t&x/tE/Sun	㆙つ㆒
t&x/tE/mun	㆙つだ
t&x/tE/to	㆙つ〙
t&x/tES	㆙㉩
t&x/tEt	㆙㕶
t&xt	㞒
tE	つ
tE/da/dE	つ〴あ
tE/da/dES	つ〴㈴
tE/ki/yE	つ〥〤
tE/ku/nES	つ㉗㉳
tE/kun	つ㝅
tE/lE	つぅ
tE/lE/SE	つぅㅠ
tE/lE/fo/n&m	つぅ㎆〗
tE/lE/fo/nE	つぅ㎆〆
tE/lE/fo/nES	つぅ㎆㉳
tE/lE/fo/nEt	つぅ㎆ㄲ
tE/lE/fon	つぅ㤴
tE/lE/vi/ZE/nE	つぅ㒇䄵〆
tE/lE/vi/ZE/ni	つぅ㒇䄵こ
tE/lE/vi/ZEn	つぅ㒇㚘
tE/ni/sE	つこ〇
tE/ni/sE/mun	つこ〇だ
tE/ni/sEt	つこㅸ
tE/ni/sa	つこ㈆
tE/nis	つ㎅
tE/nis/dri/ming	つ㎅䕃䕄
tE/ra/fi/ki	つㅹ㉥〥
tE/ra/fik	つㅹ䠑
tE/ra/sES	つㅹ㐃
tE/ra/to/ro	つㅹ〙〹
tE/rak/tor	つ㢃㉅
tE/ras	つ㍇
tE/ta/mus	つゅ䥀
tES/n&/mE	㉩ゔㆂ
tES/nE	㉩〆
tEf/l&/ki	㎘㌧〥
tEh/ra/nE	䉘ㅹ〆
tEh/ran	䉘㔁
tEk/ni/xa/yE	䀤こし〤
tEk/ra/ri	䀤ㅹ〵
tEk/rar	䀤㔴
tEm/sa	㊐㈆
tEr/mE	㞀ㆂ
tEr/mi/nal	㞀〃㤡
tErm	䕧
tEs/tE	㢑つ
tEst	㢐
ta	ゅ
ta/E/i	ゅ【〷
ta/GE	ゅ㌲
ta/GES	ゅ㔶
ta/GES/d&n/du/naS	ゅ㔶ぱㄩ㉒
ta/GEr	ゅ㜡
ta/at/r&m	ゅ㥔㄄
ta/at/rE	ゅ㥔〕
ta/at/rE/Sun	ゅ㥔〕㆒
ta/at/rES	ゅ㥔て
ta/at/ri	ゅ㥔〵
ta/atr	ゅ䍒
ta/atr/na/mE	ゅ䍒〸ㆂ
ta/b&m	ゅ㙢
ta/bE	ゅ】
ta/bE/hal	ゅ】㔔
ta/bEs/tan	ゅ㎕㎖
ta/bEs/tu/ni/mun/y&/ni	ゅ㎕ㅡこだ㍗こ
ta/bo	ゅぶ
ta/ip	ゅ䡀
ta/kun	ゅ㝅
ta/m&n/Ge/ri	ゅ㄁㕕〵
ta/ma/Sa/ci/ha	ゅ〖〨ぉと
ta/nES	ゅ㉳
ta/rE	ゅ〕
ta/ri/kE	ゅ〵ㄢ
ta/ri/kE/doz	ゅ〵ㄢ㕆
ta/ri/ki	ゅ〵〥
ta/ri/ku/m&/dE	ゅ〵㉗ばあ
ta/ri/xES	ゅ〵㌃
ta/rik	ゅ䁗
ta/ro/ma/lE/Sun	ゅ〹〖ぅ㆒
ta/ro/mal	ゅ〹㔹
ta/rof	ゅ䝸
ta/un	ゅ〣
ta/vus	ゅ䍳
ta/z&st	ゅㄙ
ta/zE	ゅㄕ
ta/zE/gi/ya	ゅㄕんㄈ
ta/zE/t&/rE	ゅㄕㄒ〕
taG	䘡
tab	㕄
tab/lo	㕄㌳
tab/lo/E	㕄㌳【
tab/tab	㕄㕄
tak	㠩
tak/si	㠩々
tak/si/ya	㠩々ㄈ
tan/kE	㎖ㄢ
tank	㝁
tank/ba/zi	㝁〱ㄵ
tar/z&n	䂙㊖
tas	䡉
taxt	䥡
tay/gE/rE	䖕ぴ〕
tay/gE/ra	䖕ぴㅹ
tay/gEr	䖕㘓
taym	䊈
te	㜃
te/lor	㜃䌲
tek/wan/do	䐷䐸〰
tek/wan/do/yi	䐷䐸〰㆕
ti	ㅔ
ti/8E	ㅔ㊁
ti/8a	ㅔぃ
ti/SErt	ㅔ㢂
ti/k&/SE	ㅔㅖㅠ
ti/k&/Sun	ㅔㅖ㆒
ti/k&/r&m	ㅔㅖ㄄
ti/k&/ro	ㅔㅖ〹
ti/k&S	ㅔ䍁
ti/k&n	ㅔ㔩
ti/k&st	ㅔ㜕
ti/kE	ㅔㄢ
ti/kE/ha/mun	ㅔㄢとだ
ti/kE/yE	ㅔㄢ〤
ti/ka/ho	ㅔ㐶㌱
ti/ma/rEs/ta/nE	ㅔ〖㚕ゅ〆
ti/rE	ㅔ〕
ti/raS	ㅔㄐ
ti/rat	ㅔㄦ
ti/ro	ㅔ〹
ti/zE	ㅔㄕ
ti8	䄄
tik	㝲
tir	㚔
tiz/kon	㑳け
tizkon	䚉
to	〙
to/&m	〙〓
to/&n	〙ㅐ
to/E	〙【
to/f&N	〙䤰
to/f&n/gE	〙㔀ぴ
to/f&n/ga/tun	〙㔀㍡ㄖ
to/f&ng	〙䚓
to/i	〙〷
to/im	〙䈇
to/lid	〙㥆
to/m&/nE	〙ば〆
to/m&/ni	〙ばこ
to/m&/ni/&st	〙ばこ䁩
to/m&n	〙㄁
to/m&n/Ge/ri	〙㄁㕕〵
to/m&n/Ge/ri/ha/ro	〙㄁㕕〵と〹
to/m&n/Ge/rit	〙㄁㕕㡱
to/po/li	〙べも
to/po/li/&/mo	〙べもㅀ㈓
to/po/li/&m	〙べも〓
to/po/li/SE	〙べもㅠ
to/po/lu	〙べぢ
to/po/lu/&m	〙べぢ〓
to/po/lu/E	〙べぢ【
to/po/lu/yE	〙べぢ〤
to/pol	〙㘳
to/pu/lu/&m	〙ゆぢ〓
to/rE	〙〕
to/rE/yE	〙〕〤
to/ri	〙〵
to/ri/yE	〙〵〤
to/ro	〙〹
to/un	〙〣
to/yi	〙㆕
to/zi	〙ㄵ
to/zi/hi	〙ㄵょ
to/zih	〙䐑
tof	䄉
tof&N	䥹
tohm	䝳
tom	㑲
ton/dE	㠔あ
ton/dES	㠔㈴
ton/di	㠔び
ton/di/d&/rE	㠔び㄰〕
tond	䆙
tond/t&r	䆙〄
tor/S&n	㉅む
tor/SE	㉅ㅠ
tor/Si	㉅げ
tor/Si/E	㉅げ【
tor/dES	㉅㈴
tor/ki	㉅〥
tor/ki/E	㉅〥【
tor/ki/yE	㉅〥〤
torS	䘑
tord	䜂
tork	㥧
tost	䉳
tox/mE	㤓ㆂ
tox/mE/mor8	㤓ㆂ㤔
tox/mo/mor8	㤓㈓㤔
toxm	㔳
tr&k/tor	㢄㉅
tu	ㅡ
tu/SE	ㅡㅠ
tu/Sun	ㅡ㆒
tu/a/lE/tE	ㅡ〧ぅつ
tu/a/lEt	ㅡ〧㆔
tu/bES	ㅡ㌕
tu/h&/mE	ㅡㄱㆂ
tu/h&m	ㅡ〦
tu/h&r/v&8t	ㅡ㈄㑴
tu/ha/la	ㅡと〢
tu/i/ti	ㅡ〷ㅔ
tu/i/ti/E	ㅡ〷ㅔ【
tu/lE	ㅡぅ
tu/la/ni	ㅡ〢こ
tu/la/ni/E	ㅡ〢こ【
tu/la/ni/t&r	ㅡ〢こ〄
tu/la/ni/yi	ㅡ〢こ㆕
tu/mi/du/ni	ㅡ〃ㄩこ
tu/nEs/t&m	ㅡ㑄ㅨ
tu/nEs/tE	ㅡ㑄つ
tu/nEs/ti	ㅡ㑄ㅔ
tu/nEst	ㅡ㘉
tu/p&m	ㅡ䀶
tu/pE	ㅡㄣ
tu/pES	ㅡ䉁
tu/pEt	ㅡ㥕
tu/pa	ㅡ〘
tu/pi/E	ㅡㄉ【
tu/r&m	ㅡ㄄
tu/rE	ㅡ〕
tu/ri/ha/yE	ㅡ〵と〤
tu/ri/yE	ㅡ〵〤
tu/ti	ㅡㅔ
tu/ti/E	ㅡㅔ【
tu/ti/yo	ㅡㅔ㊕
tu/tu/lE	ㅡㅡぅ
tu/yE	ㅡ〤
tuS	㠄
tuS/v&/li	㠄㈶も
tuS/xob	㠄〶
tub/rE	䔸〕
tul	㎃
tup	㎐
tup/ba/zi	㎐〱ㄵ
tur	䀰
tus	倃
tut/f&/r&n/gi	䠡ㅂへん
tut/f&/r&n/giS	䠡ㅂへ䊀
u/E	ど【
u/Ga/E/i	ど〉【〷
u/a	ど〧
u/a/i	ど〧〷
u/ah	ど㤠
u/an	ど䉂
u/m&/d&m	どばㅕ
u/m&/d&n	どばぱ
u/m&/dE	どばあ
u/m&/di	どばび
u/m&/dim	どば㈖
u/m&/din	どば㌒
u/m&d	ど㈰
u/n&/ma	どゔ〖
u/n&/mun	どゔだ
u/n&m	ど〗
u/nE	ど〆
u/nES	ど㉳
u/na	ど〸
u/na/a/han	ど〸〧ㅉ
u/na/ha	ど〸と
u/na/haS	ど〸㉰
u/na/hi	ど〸ょ
u/na/ro	ど〸〹
u/na/yE/i	ど〸〤〷
u/na/yi	ど〸㆕
u/nam	ど䄸
u/ni	どこ
u/ni/kE	どこㄢ
u/ni/na/ro	どこ〸〹
u/no	どㆈ
u/no/ba/SE	どㆈ〱ㅠ
u/no/v&/li	どㆈ㈶も
u/su/l&n	ど㐣㍕
u/tu	どㅡ
u/xE/i	ど㈙〷
uS	䁉
ub	䤡
um	䁐
um&d&n	䔁
um/d&/di	䁐㄰び
un	〣
un/8&dr	〣㉡
un/Ga	〣〉
un/Ga/ha	〣〉と
un/Ga/yE	〣〉〤
un/Ga/yi	〣〉㆕
un/Gast	〣㉵
un/Gat	〣㠀
un/Gu/ri	〣㄀〵
un/Gu/ri/E	〣㄀〵【
un/Gur	〣㥓
un/ba8t	〣䤔
un/ci/yE	〣ぉ〤
un/d&/fE	〣㄰㈷
un/kE	〣ㄢ
un/m&/g&r	〣ば㈥
un/mo/8E	〣㈓㊁
un/r&n/gi/&n	〣へんㅐ
un/r&n/gi/yE	〣へん〤
un/ru	〣ㄹ
un/ruz	〣㈐
un/to/ri	〣〙〵
un/tu	〣ㅡ
un/v&/rE	〣㈶〕
un/v&/rE/SE	〣㈶〕ㅠ
un/v&/rES	〣㈶て
un/v&/ri	〣㈶〵
un/v&/ri/E	〣㈶〵【
un/v&8/ti	〣㉣ㅔ
un/v&8t	〣㑴
un/v&r	〣㍉
un/v&r/nE/ga	〣㍉〆㍡
un/v&r/t&/ra	〣㍉ㄒㅹ
un/v&r/t&r	〣㍉〄
un/va/8at	〣ゃ㠴
un/va8	〣䤠
un/va8t	〣䤐
un/var	〣㘕
un/yE/ki	〣〤〥
un/yE/ki/ro	〣〤〥〹
unGa	䤕
unGana	䤖
unv&8t	䒀
ups	䈗
ur	䢖
ut	䐓
ux	䝢
v&	㈶
v&/8E/yi	㈶㊁㆕
v&/RES/goft	㈶䔆ㅷ
v&/g&r/n&	㈶㈥ゔ
v&/g&r/na	㈶㈥〸
v&/hid	㈶㡸
v&/is/ta	㈶やゅ
v&/la	㈶〢
v&/last	㈶㦔
v&/li	㈶も
v&/li/&sr	㈶も㙧
v&/li/GE/di	㈶も㌲び
v&/li/ba/ba	㈶も〱〱
v&/li/mi/xay	㈶も〃ㅙ
v&/n&k	㈶㑐
v&/r&/8E/i	㈶㈀㊁〷
v&/r&/8E/i/a	㈶㈀㊁〷〧
v&/r&/8E/yE	㈶㈀㊁〤
v&/r&/8E/yit	㈶㈀㊁䂔
v&/r&8	㈶㐠
v&/rE/Sun	㈶〕㆒
v&/rES	㈶て
v&/s&/tE	㈶づつ
v&/s&/tE/to	㈶づつ〙
v&/s&/tES	㈶づ㉩
v&/s&/ta/SE	㈶づゅㅠ
v&/s&/ta/yE	㈶づゅ〤
v&/s&/ti	㈶づㅔ
v&/s&/tiS	㈶づ㝶
v&/s&t	㈶㞂
v&/sa/yE/lE	㈶㈆〤ぅ
v&/sa/yE/lES	㈶㈆〤㈱
v&/sa/yE/lEt	㈶㈆〤㆔
v&/sa/yE/la	㈶㈆〤〢
v&/sa/yE/la/Sun	㈶㈆〤〢㆒
v&/sa/yE/la/yE	㈶㈆〤〢〤
v&/sa/yE/laS	㈶㈆〤㜗
v&/sa/yEl	㈶㈆䡣
v&/zE/SE	㈶ㄕㅠ
v&/zi	㈶ㄵ
v&/zi/Er	㈶ㄵ㝰
v&/zi/fE/yE	㈶ㄵ㈷〤
v&/zi/rE	㈶ㄵ〕
v&/zi/rEt	㈶ㄵ㑣
v&/zi/rast	㈶ㄵ㈠
v&/zi/ri	㈶ㄵ〵
v&/zi/y&/tE	㈶ㄵ㍗つ
v&/zir	㈶䄇
v&8/t&m	㉣ㅨ
v&8/tE	㉣つ
v&8/tE/SE	㉣つㅠ
v&8/tES	㉣㉩
v&8/tEt	㉣㕶
v&8/ta	㉣ゅ
v&8/ti	㉣ㅔ
v&8/ti/yE	㉣ㅔ〤
v&8t	㑴
v&8tE	䠸
v&h/S&t/na/kE	㝷㝸〸ㄢ
v&h/S&t/na/ki	㝷㝸〸〥
v&h/S&t/na/ki/&n	㝷㝸〸〥ㅐ
v&h/S&t/nak	㝷㝸㢕
v&h/Si	㝷げ
v&h/Si/yE	㝷げ〤
v&l	ㅁ
v&r	㍉
v&r&8	䤑
v&r/daS/t&m	㍉㈂ㅨ
v&r/daS/t&n	㍉㈂㍔
v&r/daS/ti	㍉㈂ㅔ
v&r/diG	㍉䘅
v&r/hi/ci	㍉ょぉ
v&r/zE/S&m	㍉ㄕ㆑
v&r/zE/SE	㍉ㄕㅠ
v&r/zE/SE/mun	㍉ㄕㅠだ
v&r/zES	㍉ㄧ
v&s/lE	䍷ぅ
v&sl	㠉
v&z	㜈
v&z/nE/SE	㜈〆ㅠ
v&z/nET	㜈䜄
v&z/ni	㜈こ
vE/l&m	㔈ㆄ
vE/lE	㔈ぅ
vE/lES	㔈㈱
vE/lEn/G&/kE	㔈㒆㆗ㄢ
vE/si/lE	㔈々ぅ
vE/tE/fa/8E	㔈つ㕈㊁
vES/kun	㝨㝅
vEl	㦖
vEr/di	㘡び
vErd	䝄
va	ゃ
va/8&/nES	ゃㄷ㉳
va/8&/ni	ゃㄷこ
va/8&n	ゃ㚉
va/8E	ゃ㊁
va/8E/&n	ゃ㊁ㅐ
va/8E/i	ゃ㊁〷
va/8E/i/E	ゃ㊁〷【
va/8E/y&t	ゃ㊁㉦
va/8E/yi	ゃ㊁㆕
va/8E/yi/E	ゃ㊁㆕【
va/Si/yan	ゃげ㍷
va/hE/dE	ゃごあ
va/i	ゃ〷
va/is/t&m	ゃやㅨ
va/is/tE	ゃやつ
va/is/ta	ゃやゅ
va/is/ta/d&m	ゃやゅㅕ
va/is/ta/d&n	ゃやゅぱ
va/is/ta/dE	ゃやゅあ
va/is/ta/di	ゃやゅび
va/is/tad	ゃや㊘
va/la	ゃ〢
va/li/ba/li	ゃも〱も
va/nE/tE	ゃ〆つ
va/rE/dE	ゃ〕あ
va/rEd	ゃ㠈
va/s&/Sun	ゃづ㆒
va/s&/tun	ゃづㄖ
va/s&S	ゃ䆒
va/s&m	ゃ㑷
va/s&t	ゃ㞂
va/sE	ゃ〇
va/sE/yE	ゃ〇〤
va/sEn/kE	ゃ䄤ㄢ
va8&n	䌀
vaG	䎐
vax	䥐
vaxt	䦖
vay	ㅒ
vays/ta	䥙ゅ
vaysa	䝁
vaz	㝵
vi	㒇
vi/GE	㒇㌲
vi/GE/yE	㒇㌲〤
vi/ni/pu	㒇こゆ
vi/ni/pu/E	㒇こゆ【
vi/raG/b&d	㒇䠉㄂
vi/rus	㒇㖁
vi/ta/mi/n&n	㒇ゅ〃ふ
vi/ta/mi/nat	㒇ゅ〃㐆
vi/ta/min	㒇ゅ㉴
viG/viG	䁶䁶
viS/gun	䤲䝙
vik/to/rE	䌱〙〕
vik/tor	䌱㉅
vil	䌰
vo	㖆
vo/Gud	㖆䑃
vo/ru/G&k	㖆ㄹ㖇
vu/Gud	㞐䑃
vu/i	㞐〷
vul	䖅
vum	䈕
wa	㔘
wa/u	㔘ど
wu/di	䄗び
wudpEkEr	䄘
x&/SE/nE	㆖ㅠ〆
x&/SEn	㆖㜄
x&/Sa/yar	㆖〨㆐
x&/Sa/yar/z&/mi/nE	㆖〨㆐ㄥ〃〆
x&/b&/r&m	㆖〡㄄
x&/b&/rE	㆖〡〕
x&/b&/rES	㆖〡て
x&/b&/ra	㆖〡ㅹ
x&/b&/ra/yi	㆖〡ㅹ㆕
x&/b&/ri	㆖〡〵
x&/b&r	㆖㈤
x&/b&r/dar	㆖㈤㐑
x&/b&r/na/mE	㆖㈤〸ㆂ
x&/fE	㆖㈷
x&/kEs/t&/ri/yE	㆖䊕ㄒ〵〤
x&/l&m	㆖ㆄ
x&/la/list	㆖〢䕴
x&/la/sE/Sun	㆖〢〇㆒
x&/las	㆖㔢
x&/li/GE	㆖も㌲
x&/lil	㆖䘙
x&/mi/a/zE/kE/San/n&	㆖〃〧ㄕㄢ㞙ゔ
x&/mi/rES	㆖〃て
x&/mi/ra	㆖〃ㅹ
x&/mir	㆖㑈
x&/mir/ba/zi	㆖㑈〱ㄵ
x&/mir/nist	㆖㑈㈡
x&/r&/ro	㆖㈀〹
x&/rE	㆖〕
x&/rEG/dE/ha	㆖䔡あと
x&/ra/bE	㆖ㅹ】
x&/ra/bES	㆖ㅹ㌕
x&/raS	㆖ㄐ
x&/rab	㆖㌔
x&/rab/ka/ri	㆖㌔㐶〵
x&/ri/d&m	㆖〵ㅕ
x&/ri/d&n	㆖〵ぱ
x&/ri/dE	㆖〵あ
x&/ri/da/rim	㆖〵〴ㆅ
x&/ri/dar	㆖〵㐑
x&/ri/di	㆖〵び
x&/ri/di/mES	㆖〵び㊒
x&/ri/dim	㆖〵㈖
x&/ri/din	㆖〵㌒
x&/rid	㆖䁆
x&/rid/ci	㆖䁆ぉ
x&/run/d&n	㆖㘐ぱ
x&/rund	㆖䑷
x&/si/si	㆖々々
x&/t&/ri	㆖ㄒ〵
x&/t&r	㆖〄
x&/t&r/na/kE	㆖〄〸ㄢ
x&/t&r/na/ki	㆖〄〸〥
x&/t&r/na/ki/E	㆖〄〸〥【
x&/t&r/nak	㆖〄㢕
x&/tE	㆖つ
x&/tES	㆖㉩
x&/ta	㆖ゅ
x&/ta/yE	㆖ゅ〤
x&/ti/bi	㆖ㅔち
x&/ti/bi/E	㆖ㅔち【
x&/ya/ti/yE	㆖ㄈㅔ〤
x&/ya/tim	㆖ㄈ㐩
x&l/v&t	䠱䉹
x&m	㜹
x&n/d&/Sun	ぁ㄰㆒
x&n/d&/mun	ぁ㄰だ
x&n/d&S	ぁ㥄
x&n/d&m	ぁㅕ
x&n/d&st	ぁ㎑
x&n/d&t	ぁゐ
x&n/dE	ぁあ
x&n/dE/da/rE	ぁあ〴〕
x&n/dE/da/ri	ぁあ〴〵
x&n/dE/da/ri/yE	ぁあ〴〵〤
x&n/dE/dar	ぁあ㐑
x&n/dE/yi/&n	ぁあ㆕ㅐ
x&n/da/n&m	ぁ〴〗
x&n/di/di	ぁびび
x&n/did	ぁ㌦
x&r	㕃
x&r/c&N	㕃䀨
x&r/c&n/gE	㕃ㆁぴ
x&r/di	㕃び
x&r/gu/SE	㕃〒ㅠ
x&r/gu/SE/to	㕃〒ㅠ〙
x&r/gu/SES	㕃〒㎀
x&r/guS	㕃㐷
x&r/guS/ba/zi	㕃㐷〱ㄵ
x&r/guS/ba/zit	㕃㐷〱㤅
x&rG	䔙
x&s/t&m	㐄ㅨ
x&s/t&s	㐄䐱
x&s/t&st	㐄䌕
x&s/tE	㐄つ
x&s/tE/do/ros/tE	㐄つ〰㉨つ
x&s/tE/gi	㐄つん
x&s/tE/gi/E	㐄つん【
x&s/tE/git	㐄つ䌃
x&s/tE/i	㐄つ〷
x&s/tE/im	㐄つ䈇
x&s/tE/yi	㐄つ㆕
x&t	㦀
x&t/kE/SES	㦀ㄢ㎀
x&t/kE/SEt	㦀ㄢ㕁
x&t/kE/Sa/tun	㦀ㄢ〨ㄖ
x&t/kES	㦀㌐
xE/NE	㈙㙗
xE/Ni/E	㈙䐈【
xE/Nul	㈙䌆
xE/Nul/ba/zi/yE	㈙䌆〱ㄵ〤
xE/lE	㈙ぅ
xE/ya/bun	㈙ㄈ㘗
xEN/gul/ba/ziS	䚗㠃〱㕠
xEd/m&/tE/tun	䙰ばつㄖ
xEd/m&t/ka/rE	䙰㝡㐶〕
xEd/m&t/ka/ra/yE	䙰㝡㐶ㅹ〤
xEn/gu/l&m	䜥〒ㆄ
xEr/s&/r&m	㍘づ㄄
xEr/s&/ro	㍘づ〹
xEr/s&st	㍘㠇
xEr/sE	㍘〇
xEr/sa	㍘㈆
xEr/sat	㍘㝔
xEr/si	㍘々
xEr/si/ya	㍘々ㄈ
xEr/si/yo	㍘々㊕
xEr/so	㍘ㅇ
xErs	㝕
xErsi	䘖
xa	し
xa/b&m	し㙢
xa/b&n	し㕲
xa/bE	し】
xa/bE/SE	し】ㅠ
xa/bE/Sun	し】㆒
xa/bE/tE	し】つ
xa/bE/tun	し】ㄖ
xa/bES	し㌕
xa/bEt	し㐥
xa/ba/han	し〱ㅉ
xa/ba/lu/&n	し〱ぢㅐ
xa/ba/yE	し〱〤
xa/bi/d&m	しちㅕ
xa/bi/d&n	しちぱ
xa/bi/dE	しちあ
xa/bi/di	しちび
xa/bi/di/ci	しちびぉ
xa/bi/dim	しち㈖
xa/bid	し㘤
xa/bun/d&m	し㘗ㅕ
xa/bund	し䀳
xa/guS	し㐷
xa/h&/dE	しㄱあ
xa/h&/r&n	しㄱへ
xa/h&/rE	しㄱ〕
xa/h&/rE/Si	しㄱ〕げ
xa/h&/rE/t&m	しㄱ〕ㅨ
xa/h&/rE/tE	しㄱ〕つ
xa/h&/rE/to	しㄱ〕〙
xa/h&/rES	しㄱて
xa/h&/rEt	しㄱ㑣
xa/h&/ri	しㄱ〵
xa/h&d	し䙨
xa/h&r	し㈄
xa/hE/Si	しごげ
xa/hES	しㆇ
xa/hi	しょ
xa/hid	し㡸
xa/k&m	し㉘
xa/kE	しㄢ
xa/kEs/t&/ri	し䊕ㄒ〵
xa/kEs/t&/ri/ro	し䊕ㄒ〵〹
xa/ki	し〥
xa/ki/yE	し〥〤
xa/l&/m&m	し㌧㍲
xa/lE	しぅ
xa/lE/8i	しぅ㌶
xa/lE/gi	しぅん
xa/lE/ha/yE	しぅと〤
xa/li	しも
xa/li/E	しも【
xa/li/b&n/di/yE	しも㕲び〤
xa/li/yE	しも〤
xa/liS	し䀘
xa/mE	しㆂ
xa/mE/i	しㆂ〷
xa/mu/S&z	し㉀䕁
xa/mu/SE	し㉀ㅠ
xa/mu/SES	し㉀㎀
xa/muS	し㑗
xa/nE	し〆
xa/nE/va/dE/gi/mun	し〆ゃあんだ
xa/nE/va/dE/yE	し〆ゃあ〤
xa/no/mE	しㆈㆂ
xa/no/mES	しㆈ㊒
xa/nom	し䌥
xa/nu/m&/ro	しㄳば〹
xa/nu/mE	しㄳㆂ
xa/nu/mE/kan/ga	しㄳㆂ㜴㍡
xa/nu/ma	しㄳ〖
xa/nu/mi	しㄳ〃
xa/nu/mo	しㄳ㈓
xa/num	しじ
xa/rE/Gi	し〕㌆
xa/rE/SES	し〕㎀
xa/rEG	し䔡
xa/ru	しㄹ
xa/sE	し〇
xa/si	し々
xa/siS	し䡁
xa/tE/r&S	しつ㡢
xa/tE/rE	しつ〕
xa/tE/rE/yE	しつ〕〤
xa/tE/rE/yi	しつ〕㆕
xa/tE/ra/tE	しつㅹつ
xa/tEr	し㞀
xa/ya/bun	しㄈ㘗
xab	㑦
xab/ha	㑦と
xak	㙙
xal	㉹
xal/xa/li	㉹しも
xal/xa/li/bal	㉹しも㠗
xal/xa/li/o	㉹しも㈔
xal/xa/li/yE	㉹しも〤
xali	㌹
xam	㎓
xas/t&m	㑕ㅨ
xas/t&n	㑕㍔
xas/t&r	㑕〄
xas/tE	㑕つ
xas/tE/&m	㑕つ〓
xas/tE/gar	㑕つ㢗
xas/ti	㑕ㅔ
xas/tim	㑕㐩
xas/tin	㑕㌥
xast	䀧
xat	䤹
xe/lE	ゖぅ
xe/li	ゖも
xe/li/ha	ゖもと
xe/li/haS	ゖも㉰
xe/li/y&/ni	ゖも㍗こ
xe/li/yE	ゖも〤
xe/li/ya	ゖもㄈ
xe/lo/xob	ゖ㌳〶
xe/r&m	ゖ㄄
xe/rE	ゖ〕
xel	䢓
xel/xob	䢓〶
xeli	䍓
xeloxob	䑙
xer	㝂
xi/sE	㌢〇
xi/ya/bu/nE	㌢ㄈら〆
xi/ya/bu/nE/Sun	㌢ㄈら〆㆒
xi/ya/bun	㌢ㄈ㘗
xi/ya/lE	㌢ㄈぅ
xi/ya/lES	㌢ㄈ㈱
xi/ya/lEt	㌢ㄈ㆔
xi/ya/lat	㌢ㄈ㑹
xi/ya/li	㌢ㄈも
xi/yal	㌢䔶
xib	䤅
xis	㐴
xo/S&m	ぷ㆑
xo/SE/Sun	ぷㅠ㆒
xo/SES	ぷ㎀
xo/SEt	ぷ㕁
xo/Sa/l&m	ぷ〨ㆄ
xo/Sa/lE	ぷ〨ぅ
xo/Sa/li	ぷ〨も
xo/Sa/lo	ぷ〨㌳
xo/Sal	ぷ㙩
xo/Sal/ko/n&n/d&st	ぷ㙩ぇふ㎑
xo/Sal/ma	ぷ㙩〖
xo/b&z	ぷ䢙
xo/d&/m&m	ぷ㄰㍲
xo/d&/mE	ぷ㄰ㆂ
xo/d&m	ぷㅕ
xo/d&t	ぷゐ
xo/dE	ぷあ
xo/dE/S&m	ぷあ㆑
xo/dE/SE	ぷあㅠ
xo/dE/So	ぷあ〈
xo/dE/Su/n&n	ぷあ㐤ふ
xo/dE/Su/nE	ぷあ㐤〆
xo/dE/Sun	ぷあ㆒
xo/dE/mu/ni	ぷあ㉀こ
xo/dE/mun	ぷあだ
xo/dE/tE	ぷあつ
xo/dE/ti	ぷあㅔ
xo/dE/to	ぷあ〙
xo/dE/tun	ぷあㄖ
xo/dES	ぷ㈴
xo/dES/ka/rE	ぷ㈴㐶〕
xo/dEt	ぷ㈃
xo/dEt/n&	ぷ㈃ゔ
xo/da	ぷ〴
xo/da/fE/zi	ぷ〴㈷ㄵ
xo/da/fEz	ぷ〴㡅
xo/da/mo	ぷ〴㈓
xo/da/ya	ぷ〴ㄈ
xo/dam	ぷ㊄
xo/dast	ぷ䅵
xo/fa/S&m	ぷ㕈㆑
xo/fa/SE	ぷ㕈ㅠ
xo/faS	ぷ䉀
xo/la/sE	ぷ〢〇
xo/la/sen	ぷ〢䍧
xo/n&/kE	ぷゔㄢ
xo/n&k	ぷ㑐
xo/rES	ぷて
xo/rES/tE	ぷてつ
xo/rESt	ぷ䢐
xo/ra/k&/mE	ぷㅹㅖㆂ
xo/ra/kE/tE	ぷㅹㄢつ
xo/ra/ki	ぷㅹ〥
xo/ra/ki/So	ぷㅹ〥〈
xo/ra/ki/ya	ぷㅹ〥ㄈ
xo/ra/ki/ya/yi	ぷㅹ〥ㄈ㆕
xo/rd	ぷ㒐
xo/ri/E	ぷ〵【
xo/ru/sE	ぷㄹ〇
xo/rus	ぷ㖁
xo/su/si/y&/tE	ぷ㐣々㍗つ
xo/su/si/yE	ぷ㐣々〤
xoS	ㄘ
xoS/b&/lE	ㄘ〡ぅ
xoS/b&x/t&m	ㄘ㊙ㅨ
xoS/b&x/ta/nE	ㄘ㊙ゅ〆
xoS/b&xt	ㄘ㜸
xoS/form	ㄘ䈘
xoS/gE/l&m	ㄘぴㆄ
xoS/gE/lE	ㄘぴぅ
xoS/gE/laS	ㄘぴ㜗
xoS/gE/li/&	ㄘぴもㅀ
xoS/gE/li/E	ㄘぴも【
xoS/gEl	ㄘ㝦
xoS/gEl/t&/rE	ㄘ㝦ㄒ〕
xoS/ha/l&m	ㄘとㆄ
xoS/hal	ㄘ㔔
xoS/ki	ㄘ〥
xoS/m&/z&/So	ㄘばㄥ〈
xoS/m&/z&n	ㄘば㊖
xoS/m&/z&s/ti/n&m	ㄘば䊆ㅔ〗
xoS/m&/z&st	ㄘばㄙ
xoS/m&/zE	ㄘばㄕ
xoS/m&/zE/gi	ㄘばㄕん
xoS/m&/zE/gi/yaS	ㄘばㄕん㐸
xoS/m&/zE/kon	ㄘばㄕけ
xoS/m&/zE/t&/rE	ㄘばㄕㄒ〕
xoS/m&/zE/t&/rin	ㄘばㄕㄒㅃ
xoS/m&/zE/yE	ㄘばㄕ〤
xoS/m&/zE/yi	ㄘばㄕ㆕
xoS/m&/zE/yist	ㄘばㄕ䞗
xoS/r&N	ㄘ䉑
xoS/r&n/gE	ㄘへぴ
xoSk	㝑
xob	〶
xob/yE	〶〤
xod	㙐
xod/Si/ri/ni	㙐げ〵こ
xod/ka/rE	㙐㐶〕
xod/ka/rEt	㙐㐶㑣
xod/kar	㙐㈣
xod/nE/vi/s&m	㙐〆㒇㑷
xof/tE	䊙つ
xof/tE/yE	䊙つ〤
xolasE	䔘
xor/Si/daS	さげ㈂
xor/Sid	さざ
xor/d&/nE	さ㄰〆
xor/d&/nE/tun	さ㄰〆ㄖ
xor/d&/nES	さ㄰㉳
xor/d&/nEt	さ㄰ㄲ
xor/d&/ni	さ㄰こ
xor/d&/ni/yE	さ㄰こ〤
xor/d&/tES	さ㄰㉩
xor/d&m	さㅕ
xor/d&n	さぱ
xor/dE	さあ
xor/dE/yi	さあ㆕
xor/dES	さ㈴
xor/da/dE	さ〴あ
xor/dad	さ㙄
xor/di	さび
xor/di/Sun	さび㆒
xor/diS	さ㦕
xor/dim	さ㈖
xor/din	さ㌒
xor/ma	さ〖
xor/tu/n&m	さㅡ〗
xu/SE	㄃ㅠ
xu/Su/n&t	㄃㐤㒁
xu/b&m	㄃㙢
xu/b&n	㄃㕲
xu/bE	㄃】
xu/bi	㄃ち
xu/bi/&n	㄃ちㅐ
xu/bi/E	㄃ち【
xu/bi/SE	㄃ちㅠ
xu/bi/ha/yE	㄃ちと〤
xu/bi/ha/yi	㄃ちと㆕
xu/bi/yE	㄃ち〤
xu/bi/ya/yi	㄃ちㄈ㆕
xu/bi/yi	㄃ち㆕
xu/biS	㄃㙴
xu/bin	㄃぀
xu/bo	㄃ぶ
xu/kE	㄃ㄢ
xu/n&/SE	㄃ゔㅠ
xu/n&/Sin	㄃ゔ゙
xu/n&/So	㄃ゔ〈
xu/n&/Su/nE	㄃ゔ㐤〆
xu/n&/Su/no	㄃ゔ㐤ㆈ
xu/n&/Sun	㄃ゔ㆒
xu/n&/mE	㄃ゔㆂ
xu/n&/mo	㄃ゔ㈓
xu/n&/mun	㄃ゔだ
xu/n&/r&m	㄃ゔ㄄
xu/n&/ro	㄃ゔ〹
xu/n&/tun	㄃ゔㄖ
xu/n&S	㄃㔸
xu/n&m	㄃〗
xu/n&n	㄃ふ
xu/n&st	㄃䂄
xu/n&t	㄃㒁
xu/nE	㄃〆
xu/nE/So	㄃〆〈
xu/nE/dar	㄃〆㐑
xu/nE/hE	㄃〆ご
xu/nE/ha	㄃〆と
xu/nE/ha/yE	㄃〆と〤
xu/nE/ha/yi	㄃〆と㆕
xu/nE/haS	㄃〆㉰
xu/nE/va/dE/ha	㄃〆ゃあと
xu/nE/yE	㄃〆〤
xu/nES	㄃㉳
xu/ru/Gi/yE	㄃ㄹ㌆〤
xuS	䥅
xub	㎗
xub/n&/So/d&/ni	㎗ゔ〈㄰こ
xub/t&/rE	㎗ㄒ〕
xub/xob	㎗〶
xun	め
xun/d&/n&m	め㄰〗
xun/d&/nE	め㄰〆
xun/d&m	めㅕ
xun/d&n	めぱ
xun/dE	めあ
xun/da	め〴
xun/di	めび
xun/dim	め㈖
xun/din	め㌒
xun/ri/zi	め〵ㄵ
xun/s&rd	め㑁
xund	㘢
xur/dE	䘄あ
xurd	㌖
y&/8&/Sun	㍗ㄷ㆒
y&/8&S	㍗䒕
y&/ni	㍗こ
y&/va/S&/ki	㍗ゃ㍸〥
y&/vaS	㍗㍩
y&/x&m	㍗㜹
y&l/da	㥀〴
y&ni	䘧
y&x	㚒
y&x/c&l	㚒㤦
y&x/ca/lE	㚒ㅘぅ
y&x/ca/la/yE	㚒ㅘ〢〤
y&x/cal	㚒㝃
y&x/z&/d&st	㚒ㄥ㎑
yE	〤
yE/Gur	〤㥓
yE/a/ma	〤〧〖
yE/bE	〤】
yE/bar	〤䂕
yE/ci	〤ぉ
yE/d&/fE	〤㄰㈷
yE/di/gE	〤びぴ
yE/du/nE	〤ㄩ〆
yE/du/nE/yi	〤ㄩ〆㆕
yE/fE/rES/tE/i	〤㈷てつ〷
yE/ho	〤㌱
yE/ho/E	〤㌱【
yE/ho/yi	〤㌱㆕
yE/k&/mi	〤ㅖ〃
yE/kE	〤ㄢ
yE/ki	〤〥
yE/ki/&n	〤〥ㅐ
yE/ki/E	〤〥【
yE/ki/So	〤〥〈
yE/ki/Sun	〤〥㆒
yE/ki/yo	〤〥㊕
yE/kiS	〤㞓
yE/ko	〤ぇ
yE/ko/du/mES	〤ぇㄩ㊒
yE/kom	〤㡒
yE/m&n	〤㄁
yE/mi/tu/nE	〤〃ㅡ〆
yE/n&	〤ゔ
yE/n&/f&/rE	〤ゔㅂ〕
yE/n&/f&/ri/E	〤ゔㅂ〵【
yE/pa/yi	〤〘㆕
yE/sa/lE/yE	〤㈆ぅ〤
yE/v&/li	〤㈶も
yE/v&/r&8	〤㈶㐠
yE/xo/la/sE	〤ぷ〢〇
yE/xob	〤〶
yE/yE	〤〤
yEd&fE	䝤
yEk	〲
yEk/S&n/bE	〲む】
yEk/d&/fE	〲㄰㈷
yEk/sa/lE	〲㈆ぅ
yEk/tan	〲㎖
yEkiS	䡗
ya	ㄈ
ya/con	ㄈ㐀
ya/d&/mE	ㄈ㄰ㆂ
ya/d&m	ㄈㅕ
ya/dE	ㄈあ
ya/dE/Sun	ㄈあ㆒
ya/dE/mun	ㄈあだ
ya/dE/tu/nE	ㄈあㅡ〆
ya/dE/tun	ㄈあㄖ
ya/dES	ㄈ㈴
ya/dEt	ㄈ㈃
ya/daS/tES	ㄈ㈂㉩
ya/daSt	ㄈ㑑
ya/la	ㄈ〢
ya/ni	ㄈこ
ya/ri	ㄈ〵
ya/sEr	ㄈ䌁
ya/si/yE	ㄈ々〤
ya/xE	ㄈ㈙
ya/xi/yE	ㄈ㌢〤
yad	㉆
yad/a/v&/ri	㉆〧㈶〵
yad/ko/dum	㉆ぇ㔲
yad/z&/bu/nE	㉆ㄥら〆
yadEtE	㕐
yaf/tE	䕕つ
yax/t&/rin	㜳ㄒㅃ
yax/z&/dE	㜳ㄥあ
yaz/d&	㐰㄰
yaz/d&/ho	㐰㄰㌱
yaz/d&h	㐰㉈
yaz/d&h/ta	㐰㉈ゅ
yaz/d&h/taS	㐰㉈㐵
yaz/d&st	㐰㎑
yaz/da/hE	㐰〴ご
ye	䠒
yi	㆕
yon/GE	䙔㌲
yu	㜀
yu/ha/ha/ha	㜀ととと
yu/ni/yEn	㜀こ䤢
yu/sEf	㜀㕡
yux	㡕
yux/tE	㡕つ
yux/ti	㡕ㅔ
yux/ti/ba/ba	㡕ㅔ〱〱
yuxt	㡖
z&/ba/nE/tun	ㄥ〱〆ㄖ
z&/ban	ㄥ䁕
z&/bu/nE	ㄥら〆
z&/bu/nES	ㄥら㉳
z&/bu/nEt	ㄥらㄲ
z&/bu/ni	ㄥらこ
z&/bu/ni/E	ㄥらこ【
z&/d&/mES	ㄥ㄰㊒
z&/d&/mEt	ㄥ㄰㞗
z&/d&/n&m	ㄥ㄰〗
z&/d&/nE	ㄥ㄰〆
z&/d&/nES	ㄥ㄰㉳
z&/d&/nEt	ㄥ㄰ㄲ
z&/d&m	ㄥㅕ
z&/d&n	ㄥぱ
z&/d&n/xob	ㄥぱ〶
z&/dE	ㄥあ
z&/dE/tu/nES	ㄥあㅡ㉳
z&/dES	ㄥ㈴
z&/di	ㄥび
z&/diS	ㄥ㦕
z&/dim	ㄥ㈖
z&/din	ㄥ㌒
z&/fE/ra/nE	ㄥ㈷ㅹ〆
z&/fE/ru/ni	ㄥ㈷ㄹこ
z&/fE/run	ㄥ㈷㘐
z&/i/f&n	ㄥ〷㔀
z&/i/fE	ㄥ〷㈷
z&/if	ㄥ䌵
z&/ma/ni	ㄥ〖こ
z&/man	ㄥ〩
z&/man/ha/yE	ㄥ〩と〤
z&/mi/nE	ㄥ〃〆
z&/mi/nE/So	ㄥ〃〆〈
z&/mi/nE/bE/bi/nE	ㄥ〃〆】ち〆
z&/mi/nE/h&/mi/SE	ㄥ〃〆ㄱ〃ㅠ
z&/mi/nE/yE	ㄥ〃〆〤
z&/mi/nES	ㄥ〃㉳
z&/min	ㄥ㉴
z&/nE	ㄥ〆
z&/nE/Sun	ㄥ〆㆒
z&/nE/ba	ㄥ〆〱
z&/nES	ㄥ㉳
z&/na	ㄥ〸
z&/na/h&n	ㄥ〸㐈
z&/ni	ㄥこ
z&/no	ㄥㆈ
z&/nu/n&/ro	ㄥㄳゔ〹
z&/nu/nE	ㄥㄳ〆
z&/r&/S&m	ㄥ㈀㆑
z&/r&/rE	ㄥ㈀〕
z&/r&/ro	ㄥ㈀〹
z&/r&st	ㄥ㞅
z&/rE	ㄥ〕
z&/ra/f&t	ㄥㅹ䂑
z&/ra/fE	ㄥㅹ㈷
z&/ra/fE/yi	ㄥㅹ㈷㆕
z&/ri	ㄥ〵
z&/ri/yE	ㄥ〵〤
z&/rif	ㄥ㘔
z&N	㑱
z&b	㡴
z&b/d&r	㡴ㆉ
z&b/t&/ro	㡴ㄒ〹
z&b/tE	㡴つ
z&b/tE/sot	㡴つ䚀
z&b/tES	㡴㉩
z&b/tiS	㡴㝶
z&bt	㑘
z&d	㘙
z&dE	䘳
z&h/m&/tE	䍨ばつ
z&h/m&/tE/tun	䍨ばつㄖ
z&h/m&/ti	䍨ばㅔ
z&h/m&t	䍨㝡
z&n	㊖
z&n/Gan	㊖㍅
z&n/bi/lE	㊖ちぅ
z&n/bi/la/yE	㊖ち〢〤
z&n/bil	㊖㢔
z&n/bu/r&/ro	㊖ら㈀〹
z&n/bu/rE	㊖ら〕
z&n/bu/ro	㊖ら〹
z&n/bur	㊖䈀
z&n/gE	㊖ぴ
z&n/gu/lE	㊖〒ぅ
z&r	㖑
z&r/bE	㖑】
z&r/bE/yE	㖑】〤
z&r/bol/m&/s&/lE	㖑㔷ばづぅ
z&r/bol/m&/s&/la	㖑㔷ばづ〢
z&r/bol/m&/s&/li	㖑㔷ばづも
z&r/bol/m&/s&l	㖑㔷ば䅇
z&r/d&m	㖑ㅕ
z&r/dE	㖑あ
z&r/da/ri	㖑〴〵
z&r/di	㖑び
z&r/f&m	㖑㙓
z&r/fE	㖑㈷
z&r/fES	㖑㘶
z&r/fa	㖑㕈
z&r/fa/yE	㖑㕈〤
z&r/fi/y&/tES	㖑㉥㍗㉩
z&r/g&/ri	㖑ㄠ〵
z&rb	䞃
z&rd	㍨
z&rf	䙀
z&rf/Su/i	䙀㐤〷
z&x/mE	㕱ㆂ
z&x/mES	㕱㊒
z&x/ma	㕱〖
z&x/mi	㕱〃
z&xm	䅸
zE	ㄕ
zE/bE/l&n	ㄕ】㍕
zE/bE/lE	ㄕ】ぅ
zE/bEl	ㄕ㠂
zE/bEl/xan	ㄕ㠂ひ
zE/mEs/tan	ㄕㄅ㎖
zE/mEs/tu/nE	ㄕㄅㅡ〆
zE/mEs/tu/ni	ㄕㄅㅡこ
zE/mEs/tun	ㄕㄅㄖ
zE/min	ㄕ㉴
zE/r&N	ㄕ䉑
zE/r&n/g&m	ㄕへ㍑
zE/r&n/gE	ㄕへぴ
zE/r&ng/t&/rE	ㄕ㘂ㄒ〕
zE/rESk	ㄕ䅦
zE/yad	ㄕ㉆
zES/tE	ㄧつ
zESt	䑴
zEd	䦕
zEh/n&m	䙵〗
zEh/nEt	䙵ㄲ
zEl/zE/lE	㔰ㄕぅ
zEmn	䠘
zEn/d&/gi	を㄰ん
zEn/d&st	を㎑
zEn/dE	をあ
zEn/dE/gi	をあん
zEn/dE/gi/E	をあん【
zEn/dE/gi/di/gE	をあんびぴ
zEn/dE/gi/mi/g&m	をあん〃㍑
zEn/dE/gi/yE	をあん〤
zEn/dE/gi/ya/han	をあんㄈㅉ
zEn/dE/git	をあ䌃
zEn/da/ni	を〴こ
zEn/da/ni/E	を〴こ【
zEn/da/nit	を〴㡧
zEn/dan	を䚖
zEn/dan/b&d	を䚖㄂
zEndegiyE	䕇
za/dE	㎇あ
za/hE/r&n	㎇ごへ
za/hE/rE	㎇ご〕
za/lE	㎇ぅ
za/nu	㎇ㄳ
za/nu/E	㎇ㄳ【
za/nuS	㎇䒈
za/nut	㎇䘘
zad	㦁
zal	䠧
zb&s	㘑
ze/ka/vul	䉉㐶䖅
ze/tun	䉉ㄖ
zi/8Et	ㄵ㚑
zi/ba	ㄵ〱
zi/ba/i/yE	ㄵ〱〷〤
zi/ba/yE	ㄵ〱〤
zi/ba/yi	ㄵ〱㆕
zi/ba/yi/E	ㄵ〱㆕【
zi/bast	ㄵ㦓
zi/rE	ㄵ〕
zi/rE/SE	ㄵ〕ㅠ
zi/rE/in/Ga	ㄵ〕。〉
zi/rES	ㄵて
zi/ri	ㄵ〵
zi/ri/a	ㄵ〵〧
zi/ri/ha	ㄵ〵と
zi/riS	ㄵ㐢
zi/ya/d&/lan	ㄵㄈ㄰㍒
zi/ya/d&m	ㄵㄈㅕ
zi/ya/d&n	ㄵㄈぱ
zi/ya/dE	ㄵㄈあ
zi/ya/dES	ㄵㄈ㈴
zi/ya/di	ㄵㄈび
zi/ya/di/E	ㄵㄈび【
zi/ya/diS	ㄵㄈ㦕
zi/yad	ㄵ㉆
zi/yad/b&/c&/ro	ㄵ㉆〡㙈〹
zi/yad/goft	ㄵ㉆ㅷ
ziN	䖗
zig/z&/gE	䆕ㄥぴ
zig/z&/gi	䆕ㄥん
zig/z&/gi/E	䆕ㄥん【
zig/z&g	䆕䈄
zin	䖐
zir	䄇
zir/nE/vi/si	䄇〆㒇々
zir/pu/SEt	䄇ゆ㕁
zist/SE/na/sim	䙶ㅠ〸䍔
zo/8al/s&N	㝉㒄䞒
zo/ba/lE/ha	㝉〱ぅと
zo/r&t	㝉㡓
zo/ro	㝉〹
zo/ro/E	㝉〹【
zo/ya	㝉ㄈ
zo8	䠣
zoh/rE	㤒〕
zohr	㡥
zor	㌙
zor/ha	㌙と
zorh	䒄
zu/dE	㖅あ
zu/di	㖅び
zu/r&m	㖅㄄
zu/rE	㖅〕
zu/rE/Sun	㖅〕㆒
zu/rE/to	㖅〕〙
zu/rES	㖅て
zu/rEt	㖅㑣
zud	ㆀ
zud/t&r	ㆀ〄
zur	䆈
zur/gu/i/E	䆈〒〷【
zur/zu/ri	䆈㖅〵