@/Si	㘶㊀
@/hoI	㘶㢇
@/lI/ge/tR	㘶ち䅤ㄔ
@/lIg/z@n/dR	㘶䖐䖑㎓
@/lIks	㘶偃
@/lIn	㘶䝥
@/nI/mxl	㘶㘷㘸
@/nI/mxlz	㘶㘷䆆
@/pI/tYt	㘶㔱㍒
@/prI/kats	㘶ㅅ傆
@/pxl	㘶㜦
@/pxl/scs	㘶㜦㝱
@/pxlz	㘶㝨
@/skIG	㘶䔷
@G/gri	㎆㔷
@G/kxlz	㎆㆓
@d/vYs	儡儢
@f/tR	㉂ㄔ
@f/tR/nun	㉂ㄔ㉃
@k/Cu/x/li	㚉㉖べ㊄
@k/SIn	㚉㥁
@k/sI/dInt	㚉㊃䖖
@k/tIG	㚉〠
@k/tIv	㚉䍘
@kt	刈
@kts	剒
@l	䒂
@l/Ji	䒂㜴
@m	䍕
@n	㖘
@n/JE/lI/kx	㖘䅸ち㔧
@n/sR	㖘ㅓ
@n/sx/rIG	㖘㡇㙖
@n/tI/bY/a/tIk	㖘㚇㍆䀘䄖
@n/ti	㖘〄
@nd	ㄷ
@nt	䤠
@nts	䙰
@sk	䌴
@skt	䡩
@t	ひ
@z	㥐
C@/lIn/JIG	䝤䝥䊗
C@ns	䒖
C@t	刐
CE/kIG	㤖へ
CE/kWt	㤖㤗
CE/stR	㤖䀡
CEk	㕶
CEk/bUk	㕶㉄
CI/kIn	㔄㔅
CI/kInz	㔄㦄
CI/ki	㔄〴
CI/kiz	㔄㕑
CI/li	㔄㊄
CI/li/R	㔄㊄㑥
CIl	䁢
CIl/drIn	䁢䁣
CIm/ni	䅨㈕
CIm/p@n/zi	䅨㦘㑤
CImp	劗
CIn	㜗
CIp	䡵
CIps	㡠
CO/sIz	㢗㜁
CRp	䢒
CYmz	䘂
C^/bi	䅄゙
Capt	䢈
Cen/JIG	䊖䊗
Cen/JIz	䊖㠵
CenJ	㑄
CenJd	㑀
Cer	㒕
Ces	㙹
Cest	兘
Ci	㞓
Ci/Ciz	㞓㤒
Ci/ki	㞓〴
Ci/kiz	㞓㕑
Ci/ri/oz	㞓ㄢ候
Ci/to	㞓㙆
Ciks	䡸
Cip	䈸
Cir/fxl	䖁䁡
Ciz	㤒
Co/kIG	䡘へ
Cok	㕅
Cu	㉖
Cu/IG	㉖と
Cu/i	㉖〙
Cuz	冕
D@/txl	㜰ぢ
D@n	㍕
D@t	〥
D@ts	ぁ
DEm	㆕
DEm/sElvz	㆕䙦
DEn	あ
DIs	ゑ
DY	䝹
D^	。
De	㉠
Del	㤧
Der	じ
Der/xl	じ㝔
Derz	㄄
Di	䠣
Diz	㘅
Do	㙨
Doz	㈳
E/dx/bxl	ㄐ㢈㌆
E/fRt	ㄐ䖆
E/lx/fInt	ㄐ㘀䅰
E/lx/fInts	ㄐ㘀䐆
E/nR/Ji	ㄐ㈱㜴
E/nR/te/nIG	ㄐ㈱㌩ㆉ
E/nR/ten/mInt	ㄐ㈱冘䄶
E/ni	ㄐ㈕
E/ni/TIG	ㄐ㈕㈀
E/ni/b^/di	ㄐ㈕㒔㈷
E/ni/mor	ㄐ㈕㉀
E/ni/we	ㄐ㈕㉔
E/ni/wer	ㄐ㈕ㄒ
E/spE/Sx/li	ㄐ㍃㍄㊄
E/vR	ㄐ㉓
E/vri	ㄐㄑ
E/vri/TIG	ㄐㄑ㈀
E/vri/ba/di	ㄐㄑㄧ㈷
E/vri/w^n	ㄐㄑㆆ
E/vri/wer	ㄐㄑㄒ
EJ	䤳
Ef	倥
Eg	㜈
Eg/z@kt/li	㜈儕㊄
Eg/zIsts	㜈䐔
Eg/zcl/tId	㜈䞗㈑
Egz	䎗
Ek/sEpt	㈉㤡
Ek/sR/sY/zIG	㈉ㅓ㈐㑔
Ek/sR/sY/zIz	㈉ㅓ㈐䜠
Ek/sR/sc/sR	㈉ㅓ㐸ㅓ
Ek/sY/tIG	㈉㈐〠
Ek/sY/tId	㈉㈐㈑
Ek/splo/dId	㈉䝖〸
Ek/splo/rIG	㈉䝖㙖
Eks	㞖
Eks/kyus	㞖㞗
Eks/pEkt	㞖冂
Eks/pEn/sIv	㞖㢅㢆
Eks/pI/ri/Ins	㞖㔱ㄢ䕑
Eks/plor	㞖㢁
Eks/prEs	㞖㤩
El	㐃
El/bo	㐃䖓
El/mo	㐃ㆈ
Els	㥀
Em	䉷
Em/pti	䉷䉸
En	䖔
En/JO/IG	䖔䘡と
En/JOd	䖔兕
En/vx/lops	䖔㦇䥇
End	㌙
End/lI/sli	㌙ち㎙
Es	䑠
Es/kep	䑠䑡
Ev/ri/ba/diz	㥕ㄢㄧ㐒
I/CIG	㉈㕴
I/Ci	㉈㞓
I/gwa/nx	㉈䅶〖
I/ki	㉈〴
I/lx/stre/tId	㉈㘀兣㈑
I/m@/JI/ne/SIn	㉈㔦䅷䉥㥁
I/mI/tets	㉈㄁䜲
I/nIG	㉈ㆉ
I/n^f	㉈㑹
I/rI/te/tIG	㉈㕸㌩〠
I/txl	㉈ぢ
I/zInt	㉈㉉
IC	㕵
IG/glIS	と兴
IGk	䝱
If	㊉
Ig/no/rIG	䅵〘㙖
Ig/nor	䅵䐴
Im/pcr/txnt	䒒䙘䙙
Im/px/stR	䒒㔑䀡
In	㄀
In/CIG	㄀㕴
In/CIz	㄀㘳
In/dI/pEn/dInt	㄀㔡㢅䖖
In/di/In	㄀㈷㄀
In/dorz	㄀䁦
In/fEk/SIn	㄀匰㥁
In/pUt	㄀ぐ
In/sIst	㄀切
In/sYd	㄀㈓
In/stEd	㄀䌑
In/tEnt	㄀䑵
In/tR/nEt	㄀ㄔ冁
In/tu	㄀ら
In/tx/rE/stIG	㄀ㄱ㈶㠠
In/tx/rE/stId	㄀ㄱ㈶㘘
In/vEnt	㄀䔳
In/vI/zx/bxl	㄀㡘䜓㌆
InC/wRm	䦖䦗
It	ㄙ
Its	ㅱ
Iz	〓
Iz/re/lYt	〓㠀㖗
J@/kIt	㥗㖁
J@/miz	㥗ㄗ
J@ks	䤥
JE/li/fIS	䅸㊄㡙
JE/nI/sIs	䅸㘷䕄
JE/nx/re/SInz	䅸〖㠀㢃
JE/rx/mY/x	䅸㘩〲べ
JEn/txl	㝐ぢ
JEnt/li	偙㊄
JI/gx/lIG	䅷䁉㈨
JI/mi	䅷〈
JIG/gxlz	䊗䉅
JO	䘡
JU/lY	劙䆃
JY/Int	䎕䎖
J^Gk	冔
J^m/pIG	䙢㐀
J^m/pR	䙢㌴
J^mp	㑅
J^mps	䦉
J^st	〰
Ja/Su/x	䊀ぉべ
Ja/ni	䊀㈕
Jab	䅃
Janz	䤢
Jar	㝳
Jarz	䀃
Jc	䢃
Je	䝗
Je/kxb	䝗䠦
Je/kxbz	䝗䠧
Je/lxn	䝗䌂
Ji	㜴
Ji/ni	㜴㈕
Ji/nyxs	㜴匈
Ji/zxs	㜴䝡
Jiz	䑲
Jok	刅
Ju/IS	㤁䑙
Ju/nyR	㤁剳
Ju/sIz	㤁㜁
Jul/yx	匐䠄
Jus	ㄹ
Jx/mY/mx	㠸〲㡵
Jx/r@f	㠸䅲
OGk	㈣
Os/tR	䆐ㄔ
R/CInz	㑥䆙
R/li	㑥㊄
R/li/R	㑥㊄㑥
R/ni	㑥㈕
RT	䞀
RT/kwek	䞀䥡
Rnd	內
S@l	䜄
SE/pRd	剗剘
SEf	䥘
SElf	䢉
SIft	匧
SRt	㕦
SRts	㜃
SU/dxnt	㝦㌈
SU/dxv	㝦䄹
SU/gR	㝦㍔
SUd	㊘
SUk	儔
SUr	㞘
SY	䂀
SY/nIG	䂀ㆉ
SY/ni	䂀㈕
S^/vx/lIG	㦆㦇㈨
S^t	㚅
S^v	㔰
Sa/pIG	㢙㐀
Sakt	䡁
Sarp	䤲
Scrt	㙘
Se/kIG	䑩へ
Sedz	冑
Sek	㜱
Seks	䡗
Sem	䤨
Sep	㕰
Seps	㜑
Sept	䡔
Ser	䄐
Serd	倱
Si	㊀
Sil	䄳
Sil/dId	䄳〸
Sild	㠈
Sip	䁗
Sits	䉳
Siz	㆐
So	㉅
So/IG	㉅と
Sod	㔤
Sol/dR	䜡㎓
Sol/dRz	䜡䁲
Su	ぉ
Su/lIs	ぉ㠴
Su/le/sIz	ぉㅀ㜁
Su/tIG	ぉ〠
Sut	䘅
Suz	㞆
T@G/kyu	㌤㌥
T@Gk	䔤
T@Gks	䤒
TIG	㈀
TIG/kIG	㈀へ
TIGk	㔖
TIGks	㠣
TIGz	㔵
TIk	㔘
TIn	䌷
TR/ma/mx/tR	䚖ぅ㡵ㄔ
TR/ti	䚖〄
TR/tin	䚖䙧
TRd	䕨
TRs/ti	㈖〄
TRst	具
TW/zInd	則剈
T^m	㚀
Tcrn/bU/Sxz	䈰㊈䈱
Tct	䈔
Tr@/SR	䕒䕓
Tr@S	䕈
Tri	㈂
Tro	㕧
Tro/IG	㕧と
Trot	㐨
Troz	䘇
Tru	㙒
W	ど
W/R	ど㑥
W/Rz	ど㜨
WC	䉩
WE/rR	儸㄂
W^t/Cx	てで
Wl	䅅
Wn/sIz	䠒㜁
Wt	【
Wt/fIt	【㙑
Wt/lEt	【㌉
Wt/sYd	【㈓
Wt/tck	【㠆
Y	ㅷ
Y/di/x	ㅷ㈷べ
Y/si	ㅷゔ
Yd	䕶
Yl	㕠
Ym	ㄠ
Ys	㘈
Yv	䅓
Yz	䈲
^	〷
^/DR	〷ㅉ
^/DR/wYz	〷ㅉ䙡
^/h^	〷ㅕ
^/h^m	〷䠰
^/nyxn	〷㔔
^/o	〷】
^G/kxl	䌩ㅔ
^g/li	䜒㊄
^m	㘣
^n/dR	㎒㎓
^n/dR/arm	㎒㎓䔃
^n/dR/armz	㎒㎓䄂
^n/dR/niT	㎒㎓䒈
^n/dR/st@nd	㎒㎓㌦
^n/dR/wer	㎒㎓ㄒ
^n/d^n	㎒㝘
^n/du	㎒〗
^n/fri	㎒䂅
^n/ru/li	㎒䆂㊄
^n/sn@p	㎒㎀
^n/sn@pt	㎒㚈
^n/str@p	㎒㎈
^p	け
^p/sEt	け㜷
^p/sYd	け㈓
^p/si	けゔ
^p/sx	け㡇
^s	㊅
^v	ㄨ
a	䀘
a/ha	䀘䅢
a/nIst/li	䀘全㊄
a/px/zIt	䀘㔑㝁
af	䜇
ak/to/bR	㡶㙆㌂
ak/tx/pxs	㡶ㄱ儐
an	う
an/lYn	う㤣
an/tu	うら
ap	㢂
ap/SInz	㢂㢃
ar	だ
ar/CIz	だ㘳
ar/farf	だ䤘
ar/mi	だ〈
ar/sElf	だ㔨
arg/yu/IG	䅣〨と
ark	䥒
arm	䔃
armz	䄂
arnt	㐠
b@/Trum	㐓㦒
b@/blIG	㐓䅥
b@/kIG	㐓へ
b@/kcr/dRd	㐓㈰䐃
b@/kwRdz	㐓䒁
b@/kyard	㐓䑰
b@/lx/ri/nx	㐓㘀ㄢ〖
b@/lxns	㐓䍴
b@/skIt/bcl	㐓㐔㍘
b@/skIts	㐓䉶
b@/tx/ri	㐓ㄱㄢ
b@G	㌨
b@G/IG	㌨と
b@Gk	䦒
b@T	㝅
b@T/t^b	㝅㌣
b@Ts	䡐
b@d	㑘
b@g	㝠
b@gz	㡆
b@k	ㅡ
b@k/twIst	ㅡ䦔
b@kt	䔓
b@m	䍇
b@s/kIt	㘧㖁
b@t	䙒
bE/drum	ㄓ䄠
bE/li	ㄓ㊄
bE/tR	ㄓㄔ
bEd	㌲
bEd/tYm	㌲㉁
bEdz	䘒
bEl	䍷
bElC	䝧
bElt	㥒
bEn/Jx/mIn	䒉㠸䥸
bEn/dIG	䒉ぴ
bEnd	䔒
bErz	䅔
bEst	䕧
bEt	㐣
bI/bi	㒃゙
bI/gR	㒃㍔
bI/k^/mIG	㒃ㅥ㙴
bI/k^m	㒃ぃ
bI/skIts	㒃䉶
bI/tR	㒃ㄔ
bI/ti	㒃〄
bI/zi	㒃㑤
bIG/go	䌁ぇ
bIG/ki	䌁〴
bIb	㒈
bIg	す
bIl	兖
bIl/dIG	兖ぴ
bIl/dIGz	兖䍁
bIld	䤖
bIn	㍵
bIt	㉑
bO	㘗
bOl	䠉
bOz	傀
bR/di	㌂㈷
bR/nIG	㌂ㆉ
bRT/de	儨ㄶ
bRd	䁑
bRd/fi/dR	䁑㌖㎓
bRdz	䖈
bRk	剀
bRn	䡦
bRp	䌗
bRps	偵
bRpt	傉
bRt	䤄
bU/gR	㊈㍔
bU/gi	㊈〆
bU/ki	㊈〴
bU/kiz	㊈㕑
bU/li	㊈㊄
bU/li/IG	㊈㊄と
bU/liz	㊈㠒
bUk	㉄
bUks	㈴
bUl/frag	䅦䅧
bWn/dR	㙢㎓
bWn/sIG	㙢ㅩ
bWn/sR	㙢ㅓ
bWn/si	㙢ゔ
bWns	㐘
bY	㍆
bY/bY	㍆㍆
bY/bYz	㍆䉂
bY/bxl	㍆㌆
bY/na/kyx/lRz	㍆㍇㍈ㅦ
bY/sI/kxl	㍆㊃ㅔ
bY/tIG	㍆〠
bYk	䍙
bYt	㐵
bYts	㦉
b^/bx/lR	㒔ㆁ㖕
b^/bxl	㒔㌆
b^/bxlz	㒔㔈
b^/di	㒔㈷
b^/diz	㒔㐒
b^/gIG	㒔䈅
b^/kIt	㒔㖁
b^/kxl	㒔ㅔ
b^/kxlz	㒔㆓
b^/mR	㒔㌶
b^/mi	㒔〈
b^/miz	㒔ㄗ
b^/ni	㒔㈕
b^/ni/r@/bIt	㒔㈕ㅆ㉑
b^/ni/r@/bIts	㒔㈕ㅆ䦄
b^/niz	㒔䎐
b^/stId	㒔㘘
b^/t@/n^t	㒔㝹ㆃ
b^/tR/bcl	㒔ㄔ㍘
b^/tR/flYz	㒔ㄔ包
b^/tR/n^/ti	㒔ㄔ㎕〄
b^/tRf/lY	㒔䔧䆃
b^/txn	㒔㕄
b^/txnz	㒔䚗
b^d	䤰
b^dz	䕥
b^g	䤷
b^gd	䙤
b^gz	䦘
b^m	䁳
b^m/bxl/biz	䁳㌆㔗
b^m/pI/ti	䁳㔱〄
b^mp	㈇
b^mpt	㈅
b^nC	㒇
b^s	䁈
b^s/tR	䁈ㄔ
b^st	匕
b^t	㉰
ba	ㄧ
ba/Dx/rIG	ㄧ䥩㙖
ba/bak	ㄧ㈒
ba/bx	ㄧㆁ
ba/di	ㄧ㈷
ba/txl	ㄧぢ
ba/txlz	ㄧ䆘
ba/txm	ㄧ䕅
baG/go	刲ぇ
baG/goz	刲ㅶ
baGk	䍈
baGkt	們
baks	㉸
bap	倷
bar	㐅
bar/bElz	㐅刳
bar/bx/kyu	㐅ㆁ㌥
bar/kIG	㐅へ
bar/ni	㐅㈕
bark	䤶
barz	䔱
bc/lIG	兡㈨
bc/sIG	兡ㅩ
bcl	㍘
bcl/gem	㍘㦈
bcl/mEks	㍘㙷
bcl/tI/mcr	㍘㚇々
bclz	㌑
bcrn	劘
bct	㊂
be/be	゘゘
be/bi	゘゙
be/bi/kek	゘゙㡹
be/biz	゘㔗
be/kRz	゘㢓
be/sIk	゘䄕
beb	㖉
bebz	到
bek	䜹
ber	㦙
berz	䥁
bes/bcl	䄵㍘
bes/mInt	䄵䄶
bi	゙
bi/IG	゙と
bi/IGz	゙剹
bi/and	゙䈩
bi/tIG	゙〠
bi/trIks	゙制
bi/txn	゙㕄
bidz	䤉
bif	䤹
bin	䘰
binz	㡩
bip	䀳
bit	㈄
bits	㡴
bl@G/kIt	䁆㖁
bl@G/kIts	䁆㖃
bl@G/ki	䁆〴
bl@k	䁖
blE/sId	䞔䎉
blEs	㐑
blIG/kIG	䅥へ
blIGk	䥠
blYnd	䝵
blYndz	䔂
bl^/stx/ri	偦䠸ㄢ
bla	䅂
blak	䅉
blaks	㜤
blakt	傗
blid	䡤
blo	䈹
blo/IG	䈹と
blu	ㅰ
blu/bE/ri	ㅰㄓㄢ
bluz	剴
bo	䖓
bo/bo	䖓䖓
bo/bo/ni	䖓䖓㈕
bo/gxs	䖓䘕
bo/ni/no	䖓㈕〘
bo/nin	䖓䖒
bo/rIG	䖓㙖
boT	㕒
bol	㝤
bolz	䤙
bon	䒆
bonz	㞔
bot	䡒
bots	兇
br@n/CIz	䈥㘳
br@nC	䘁
br@nd	儀
brEd	㤉
brEk/fxst	㐩㐰
brEst	䠓
brI/sko	㌓㌔
brI/skoz	㌓㙸
brI/tI/ni	㌓㚇㈕
brIG	㎑
brIG/IG	㎑と
brIJ	㠗
brIt/ni	倩㈕
brIt/niz	倩䎐
brU/klIn	䐲䐳
brWn	䁐
brY/In	㤢㄀
brYt	䤐
br^/DRz	䄩䁵
br^/SIG	䄩㝇
br^S	䄧
brcT	䘸
brcd	匘
brct	䞉
bre/kx/bxl	䦕㔧㌆
brek	䎄
bres/lIt	䦓㈢
brev	䢔
bri/DIG	やゅ
brif/kes	䘥䘦
briz	䔥
bro/kxn	䕇䄔
brok	䤱
bruz	䉀
bu	㙤
bu/bi	㙤゙
bu/bu	㙤㙤
bu/bu/Sxz	㙤㙤䈱
bu/bu/ni	㙤㙤㈕
bu/bu/ni/no	㙤㙤㈕〘
bu/bu/nin	㙤㙤䖒
bu/bu/ninz	㙤㙤䘤
bu/bun	㙤䘓
bu/bunz	㙤䘣
bu/mx/r@G	㙤㡵䎑
bu/ti	㙤〄
bu/tiz	㙤㘠
buS	䠃
bum	づ
bup/si/bu	䢖ゔ㙤
bups	䢗
but	匣
buts	偩
bx/for	ㆁㅣ
bx/g^n	ㆁ䂘
bx/hYnd	ㆁ㥨
bx/kcz	ㆁㆂ
bx/lcG	ㆁ㑴
bx/lcGz	ㆁ䜙
bx/liv	ㆁ㔁
bx/lo	ㆁㄉ
bx/lu/gx	ㆁ㑓䁉
bx/lunz	ㆁ㤳
bx/n@/nx	ㆁ㐥〖
bx/n@/nxz	ㆁ㐥㢘
bx/sYdz	ㆁ匩
bx/twin	ㆁ䍆
byu/tI/fxl	䁠㚇䁡
c	ㄆ
c/fIs	ㄆ䤁
c/fRd	ㄆ偑
c/fx/li	ㄆ䕸㊄
c/fxl	ㄆ䁡
c/fxlz	ㄆ䥂
c/fxn	ㄆ儆
c/kwRd	ㄆ傒
c/lwez	ㄆㄇ
c/rIn/JIS	ㄆ㞀㞁
c/rIn/JIz	ㄆ㞀㠵
c/rInJ	ㄆㅒ
c/sxm	ㄆ䌤
c/tx/m@/tIk	ㄆㄱ㔦䄖
cf	㆔
cg/mEn/tIn	北㌢刂
cl	め
cl/most	めㆄ
cl/rE/di	め㈶㈷
cl/rY/ti	め㠶〄
cl/rYt	め㌧
cr	㙣
cr/dRd	㙣䐃
cr/gx/nYzd	㙣䁉䠳
d@/d@	ㅖㅖ
d@/d@/d@	ㅖㅖㅖ
d@/d@/d@z	ㅖㅖ㤴
d@/d@z	ㅖ㤴
d@/di	ㅖ㈷
d@/diz	ㅖ㐒
d@/dxl	ㅖ㙓
d@/fi	ㅖ㌖
d@d	䌵
d@dz	偓
d@l/me/SIn	䅩㑁㥁
d@mp	䚄
d@n/di	㝒㈷
d@n/sIG	㝒ㅩ
d@n/yxl	㝒剄
d@ns	䁀
d@t	匨
dE/fI/nIt/li	䄥㊖䉑㊄
dE/sx/bxlz	䄥㡇㔈
dE/zI/tIn	䄥㙰刂
dEd	䕦
dEk	傕
dEsk	㜘
dI/SIz	㔡㝙
dI/dxnt	㔡㌈
dI/frInt	㔡㤃
dI/frcst	㔡䠕
dI/lxn	㔡䌂
dI/nR	㔡㈱
dI/nY	㔡䕆
dI/rEk/SIn	㔡䠈㥁
dI/rEk/SInz	㔡䠈㢃
dI/sEm/bR	㔡匒㌂
dI/sY/dId	㔡㈐〸
dI/sYd	㔡㈓
dI/sk^/vRd	㔡䐹䌕
dI/str@k/tIG	㔡䜷〠
dI/tR/JInt	㔡ㄔ㤇
dI/tR/mInd	㔡ㄔ䎁
dI/vW/R	㔡劑㑥
dI/z@s/tR	㔡䙆ㄔ
dI/zYr	㔡䠢
dI/zi	㔡㑤
dIG	ぴ
dIS	䜤
dIS/wa/SR	䜤぀䕓
dId	〸
dIg	䜣
dIp/si	匔ゔ
dIs	䑕
dIs/k^/vR	䑕ㅥ㉓
dIs/px/zI/SIn	䑕㔑㙰㥁
dIs/tRb	䑕偂
dIs/tr@k/SIn	䑕䜸㥁
dIs/trO	䑕䔵
dR/ti	㎓〄
dRt	䖇
dRts	䖉
dWn	〹
dWn/lod	〹划
dWn/sterz	〹ん
dY/It	㐹ㄙ
dY/di	㐹㈷
dY/diz	㐹㐒
dY/i/Sx	㐹〙㍄
dY/mxnd	㐹䢇
dY/nI/scr	㐹㘷䥈
dY/pR	㐹㌴
dY/pRz	㐹㜂
dY/pi	㐹㐦
dYd	兒
dYl	䡳
dYv	䂐
d^/bxl	㒘㌆
d^/bxl/yu	㒘㌆〨
d^/ki	㒘〴
d^/kiz	㒘㕑
d^/zxnt	㒘㒙
d^b	㌡
d^k	䁓
d^m	劆
d^mp	䎃
d^mp/ti	䎃〄
d^n	㝘
d^s/ti	兔〄
d^st	倐
d^z	㍥
da	㞅
da/li	㞅㊄
da/liz	㞅㠒
da/nx	㞅〖
da/nxld	㞅偤
dak/tR	䍥ㄔ
dark	㠅
darn	偉
dc/gcn	㊑㕂
dc/gi	㊑〆
dc/giz	㊑ㄥ
dc/tR	㊑ㄔ
dcg	〡
dcgz	㕈
dcl	㉡
dcl/fInz	㉡䂉
dcs	兓
de	ㄶ
de/rIG	ㄶ㙖
de/ri	ㄶㄢ
de/tYm	ㄶ㉁
de/vId	ㄶ剆
den/Jx/rxs	䜳㠸䜴
der	䕕
dez	䂗
di	㈷
di/di	㈷㈷
di/di/di	㈷㈷㈷
di/hY/dre/tId	㈷ゕ㔴㈑
dil	㥓
dip	䂂
dir	㈦
do/n^t	〵ㆃ
do/si	〵ゔ
do/tIG	〵〠
dont	ㅸ
dor	㊆
dor/bEl	㊆䍷
dorz	䁦
dr@Gk	䑇
dr@g	䖀
dr@gd	㙇
drE/sIG	㡓ㅩ
drE/sR	㡓ㅓ
drEd/fxl	倁䁡
drEnCt	䖅
drEs	䙷
drEst	㑙
drI/pIG	化㐀
drIG/kIG	䡅へ
drIG/ki	䡅〴
drIGk	ㄲ
drIGks	㡧
drIl	兗
drY	㘃
drY/vR	㘃㉓
drYd	䀱
drYr	䊇
drYv	㠂
drYv/we	㠂㉔
dr^/mIG	㌵㙴
dr^/mR	㌵㌶
dr^m	䕖
dr^mz	䑐
dra/pIG	㘨㐀
drap	㐁
draps	䉆
drapt	㔸
drc/IG	䔗と
drcr	㒉
drcrz	倇
dri/mIG	㒒㙴
drim	偡
dru/lIG	䝢㈨
dru/li	䝢㊄
drul	兹
du	〗
du/IG	〗と
du/dxl	〗㙓
du/x/lIG	〗べ㈨
dud	䝦
duks	匀
dx/ko/tx	㢈㉦ㄱ
dx/ko/txz	㢈㉦䦐
dx/l^ks	㢈㢉
dyx	剶
e	〦
e/bi/si	〦゙ゔ
e/bi/siz	〦゙䉁
e/bxl	〦㌆
e/prxn	〦䠴
e/prxn/strIG	〦䠴䑢
e/tin	〦䙧
eC	倦
eJ	判
ed	儒
en/Jxlz	䠀䠁
ent	䑃
er	㑶
er/plen	㑶㑷
et	㍶
f@/mx/li	䔁㡵㊄
f@/sI/ne/tId	䔁㊃䉥㈑
f@/sIn	䔁䉇
f@/sInz	䔁偧
f@/stR	䔁䀡
f@kt	㠤
f@m/liz	䥳㠒
f@n	䄓
f@st	㚓
f@t	䌸
fE/lo	䜑ㄉ
fE/ri	䜑ㄢ
fEd	䅖
fEl	㥸
fElt	䉨
fEns	䚉
fI/SIz	㊖㝙
fI/Si	㊖㊀
fI/Siz	㊖㆐
fI/gyR	㊖䎂
fI/lIG	㊖㈨
fI/nIS	㊖㞂
fI/nISt	㊖㊗
fIG/gR	㠢㍔
fIG/gR/nel	㠢㍔䀉
fIG/gR/prInts	㠢㍔䑷
fIG/gRz	㠢䉗
fIS	㡙
fIS/bol	㡙㝤
fIf/tin	䚕䙧
fIg/yRd	㥇䝑
fIg/yRz	㥇㥈
fIgz	剔
fIk/sIG	㥢ㅩ
fIk/sx/bxl	㥢㡇㌆
fIks	䅹
fIkst	剧
fIl	䌆
fIsts	匢
fIt	㙑
fIts	䉖
fR	㌅
fR/bi	㌅゙
fRst	㔲
fU/ti	䙥〄
fUl	䌒
fUt	㚗
fUt/prInts	㚗䑷
fUts	傖
fWn/txn	䡆㕄
fWnd	㖐
fY/do	䝸〵
fY/nx/li	䝸〖㊄
fY/tIG	䝸〠
fYn	㜳
fYn/dIG	㜳ぴ
fYnd	㖆
fYr	㝢
fYr/ples	㝢㖑
fYt	䐷
fYv	㈁
f^/ni	㊔㈕
f^/sIG	㊔ㅩ
f^/sR	㊔ㅓ
f^/si	㊔ゔ
f^/siz	㊔䉁
f^/zi	㊔㑤
f^n	㍐
f^s	䐠
f^s/b^/kxt	䐠㒔冄
f^z	㌐
fa/DR	ㄈㅉ
fa/DRz	ㄈ䁵
fa/lo	ㄈㄉ
fa/lo/IG	ㄈㄉと
fa/nIks	ㄈ劕
fa/si	ㄈゔ
far	㙱
far/DR	㙱ㅉ
far/mR	㙱㌶
farm	䉰
fc/lIG	ㅳ㈨
fc/lxn	ㅳ䌂
fc/rIst	ㅳㅴ
fc/sxl	ㅳ䅱
fcl	㑗
fclt	䝄
fclz	䆀
fcr	〱
fcr/bI/dxn	〱㒃䙱
fcr/gEt	〱い
fcr/gat	〱ㅂ
fcr/myx/lx	〱㤂㘀
fcr/ti	〱〄
fcr/wRd	〱䍃
fe/kIG	っへ
fe/kR	っつ
fe/sIG	っㅩ
fe/sIz	っ㜁
fe/vR	っ㉓
fe/vx/rIt	っ㦇䁄
feT/fxl	䞅䁡
fek	䕤
fer	䙄
fes	㜕
fes/klaT	㜕倆
fi/dIG	㌖ぴ
fi/lIG	㌖㈨
fi/lIGz	㌖䔢
fid	㒗
fil	㌗
filz	䌖
fir	䍡
fit	㕨
fits	㝖
fl@S/lYt	䐂㖗
fl@t	䕰
flI/pIG	倂㐀
flIp	㥵
flW/R	㜧㑥
flW/Rz	㜧㜨
flWnt/si	䉢ゔ
flY	㑆
flY/IG	㑆と
fl^/fi	䡉㌖
flap/si	䥹ゔ
fle/vR/fxl	䘱㉓䁡
fle/vRd	䘱䌕
fleks	刡
flo/IG	䝴と
flor	㌒
flot	䡑
flots	光
floz	䞒
flu	ㄴ
flu/Idz	ㄴㄵ
fol/dIG	䉴ぴ
fol/dId	䉴〸
fold	㜒
fon	㊓
fonz	㙕
for	ㅣ
for/hEd	ㅣ㈆
for/sIG	ㅣㅩ
for/tin	ㅣ䙧
forT	䒙
frE/di	㠁㈷
frES	剕
frEnC	㡱
frEnd	䑨
frEndz	䂓
frI/li	䅘㊄
frY/de	䊉ㄶ
fr^/stre/tId	兢兣㈑
fr^m	㉨
fr^nt	㕓
frc/gi	䥦〆
frc/giz	䥦ㄥ
frcg	䁕
frcs/ti	䥖〄
fri	䂅
fro/zIn	㤐㤑
frut	㢔
fu/lIG	劖㈨
fud	〢
fudz	倠
fx/rE/vR	䕸㈶㉓
fyu	ㅃ
g@/bi	冗゙
gE/tIG	㙧〠
gEs	䁶
gEt	い
gEts	㑳
gI/gxl	㜡㎇
gI/gxlz	㜡䉅
gI/mi	㜡〈
gI/tar	㜡元
gI/vIG	㜡㉕
gI/vR	㜡㉓
gIfs	䥑
gIft	䕃
gIl/ti	䠆〄
gIt	䠵
gIv	㖇
gR/bR	㍔㌂
gR/li	㍔㊄
gRl	さ
gRlz	㉙
gU/di	䦁㈷
gUd	ご
gUd/nIs	ご䉦
gWn	剢
gY	䘔
gYz	㥦
g^/nx	〕〖
g^m	㤱
g^mp	䍒
g^mz	䥨
g^s	傐
ga/Cx	㄰で
ga/tx	㄰ㄱ
ga/txn	㄰㕄
gad	䀵
gadz	券
gar/bIJ	䦅䦆
gar/dxn	䦅䙱
gat	ㅂ
gcn	㕂
gem	㦈
gemz	㥖
get	㐉
gets	㝗
gev	䀸
gir	䝆
girz	䝅
gl@/sIz	䁁㜁
gl@d	䌳
gl@s	䑱
gl^b/gl^b	兑兑
gl^mp	䍔
gl^v	傄
gl^vz	偣
glo/rI/fY	䝷㕸䝸
glo/rI/fYd	䝷㕸䠠
glo/ri	䝷ㄢ
go	ぇ
go/IG	ぇと
gol	㘥
gol/dfIS	㘥㞑
gol/di	㘥㈷
gold	䁘
got	䔄
goz	ㅶ
gr@/bIG	㊁䌁
gr@/ma	㊁ぅ
gr@/ni	㊁㈕
gr@b	䈇
gr@bd	㙅
gr@m/pa	䐰㖀
gr@nd/maz	䠨䡖
gr@nd/paz	䠨䠩
gr@s	䎈
grEg	䖙
grIl	㐆
grIn	劈
grIp	䑗
grW/Ci	匡㞓
grWnd	㚃
grYnd	偄
gr^nt	〧
gre	㜠
gre/SIs	㜠䝔
gre/tIst	㜠䌘
gre/xm	㜠㔇
greps	䁷
gres	䞈
gret	䊐
gret/fxl	䊐䁡
gret/li	䊐㊄
grets	倓
gri/di	㔷㈷
gri/si	㔷ゔ
grif	匇
grin	㈃
gris	剖
gro	㌷
gro/IG	㌷と
gro/sI/ri	㌷㊃ㄢ
gro/sI/riz	㌷㊃㤰
gros	㔆
gu/gu/Yd	冃冃䕶
gus	䀗
gx/rI/lx	䁉㕸㘀
gx/z^nd/hYt	䁉䠶䠷
h@/GR	㉱䊂
h@/dxnt	㉱㌈
h@/lx/lu/yx	㉱㘀㑓䠄
h@/lx/win	㉱㘀䀦
h@/mR	㉱㌶
h@/pi	㉱㐦
h@/px/nIG	㉱㔑ㆉ
h@/pxn	㉱㆗
h@/pxnd	㉱䍳
h@/pxnz	㉱㝃
h@/vIG	㉱㉕
h@/vxnt	㉱㉲
h@/zInt	㉱㉉
h@/zRd	㉱匁
h@G	㊙
h@G/IG	㊙と
h@d	㈸
h@f	㤠
h@f/we	㤠㉔
h@g	冖
h@m	㢕
h@n/dxl	㥶㙓
h@n/sxm	㥶䌤
h@nd	㕕
h@ndz	㕘
h@t	㠱
h@v	よ
h@z	ㅐ
hE/dId	も〸
hE/dek	も䑀
hE/lI/kap/tR	もち䤴ㄔ
hE/lo	もㄉ
hE/vi	もゃ
hE/vxn	も㜲
hE/vxnz	も䞐
hEd	㈆
hEd/b^ts	㈆䌶
hEdz	䉘
hEl/pIG	䜕㐀
hEl/pR	䜕㌴
hEl/tR	䜕ㄔ
hElT	倲
hEld	䈐
hElp	㝂
hElpt	儁
hEn/ri	傅ㄢ
hEnz	䥓
hErz	䈑
hI/kxp	䅳側
hI/po	䅳䅴
hI/poz	䅳䐕
hI/tIG	䅳〠
hIlz	䈨
hIm	㈩
hIm/nxl	㈩䝇
hIm/sElf	㈩㔨
hInJ	㐗
hIp	䤩
hIt	㙁
hIz	㙐
hR	ㄕ
hR/ri	ㄕㄢ
hR/sElf	ㄕ㔨
hR/tIG	ㄕ〠
hRd	㦐
hRt	ば
hRts	䉱
hRz	㞄
hUd	䘖
hUk	倖
hUkt	劔
hW	㍉
hWd	㙗
hWz	㕩
hY	ゕ
hY/dIG	ゕぴ
hY/fYv	ゕ㈁
hY/i/nx	ゕ〙〖
hYd	䥙
hYr	㈘
h^	ㅕ
h^/gIG	ㅕ䈅
h^/mIG	ㅕ㙴
h^/ni	ㅕ㈕
h^/niz	ㅕ䎐
h^G/gri	㔶㔷
h^S	典
h^f	倴
h^g	㙉
h^gz	䢕
h^m	䠰
h^mp	䍓
h^mp/ti	䍓〄
h^n/kx/m^G/kx	䦃㔧䥧㔧
ha	䅢
ha/ha	䅢䅢
ha/lR	䅢㖕
ha/li	䅢㊄
ha/lx/rIG	䅢㘀㙖
ha/pIG	䅢㐀
hap	䈠
hapt	䈣
har/dR	傘㎓
hard	㕥
hard/hE/dxd	㕥も劀
hard/li	㕥㊄
hart	㤥
harts	䠡
has/pI/txl	匥㔱ぢ
hat	㜉
hcl	䄙
hcn	匆
hcr/sI/b@k	䉤㊃ㅡ
hcr/sIz	䉤㜁
hcr/si	䉤ゔ
hcr/siz	䉤䉁
hcrs	䁔
he	㑖
he/bi	㑖゙
heG/gRz	䊁䉗
her	㎘
her/br^S	㎘䄧
her/k^t	㎘㘕
herz	䥐
het	㍰
hi	㘹
hi/rIG	㘹㙖
hi/tR	㘹ㄔ
hi/tRz	㘹䀅
hil	ㅠ
hilz	㚘
hir	、
hirz	㒀
hit	䊒
hiz	㉧
ho	䝠
ho/li	䝠㊄
hol	㕆
hol/dIG	㕆ぴ
hold	㈗
hom	㠦
hop	㤦
hop/fx/li	㤦䕸㊄
hosts	䠅
hu	㕉
hups	䘆
huz	㉵
hxm	㕗
hyu/mxn	剸䚈
hyuJ	䐈
i	〙
i/DR	〙ㅉ
i/rek	〙倧
i/tIG	〙〠
i/txn	〙㕄
i/vxn	〙㜲
i/zi	〙㑤
i/zi/R	〙㑤㑥
iC	㕔
in/si	䀥ゔ
ir	䍠
ir/rIG	䍠㙖
irz	䈒
it	ㆀ
its	㒆
iz	䙨
k@/CIG	㔀㕴
k@/CR	㔀㔢
k@/bI/nIt	㔀㒃䉑
k@/mx/rx	㔀㡵㘩
k@/nat	㔀ㅗ
k@/rIt	㔀䁄
k@/rIts	㔀㔉
k@/ri	㔀ㄢ
k@/ri/IG	㔀ㄢと
k@/rxk/tR	㔀剷ㄔ
k@/rxk/tRz	㔀剷䀅
k@/rxl	㔀倘
k@/tx/lcg	㔀ㄱ䥕
k@C	㘱
k@G/gx/ru	䆁䁉䆂
k@mp	匤
k@n	ㅵ
k@n/di	ㅵ㈷
k@n/dxl	ㅵ㙓
k@nt	ㄘ
k@nz	䍩
k@t	㘙
k@ts	㘡
kE/Cxp	㡖㡗
kE/vInz	㡖䥅
kEl/si	䥆ゔ
kEpt	刃
kI/CIn	〃㜗
kI/kIG	〃へ
kI/sIG	〃ㅩ
kI/sIz	〃㜁
kI/si	〃ゔ
kI/ti	〃〄
kI/ti/k@t	〃〄㘙
kI/ti/k@ts	〃〄㘡
kI/ti/kI/ti	〃〄〃〄
kI/tiz	〃㘠
kI/txnz	〃䚗
kIG	へ
kIGz	䎆
kId	䕔
kIdz	䎓
kIk	㕤
kIk/bcl	㕤㍘
kIkt	㚖
kIs	䅆
kIst	䈵
kIt	㖁
kOnz	䡓
kR/txn	つ㕄
kRl	䂔
kRld	䅗
kRs	䑒
kU/SInz	㕃㢃
kU/dxnt	㕃㌈
kU/kIG	㕃へ
kU/ki	㕃〴
kU/kiz	㕃㕑
kUd	㢄
kUkt	㡉
kW	䉃
kW/bO	䉃㘗
kWC	㎔
kWn/tIG	㥠〠
kWn/ti	㥠〄
kWnt	䞁
kWz	倃
kY	儷
kYn/dx	䌃㢈
kYnd	㘴
kYndz	䐖
k^/bI	ㅥ㒃
k^/bRd	ㅥ䁑
k^/lR	ㅥ㖕
k^/lRz	ㅥㅦ
k^/mIG	ㅥ㙴
k^/pxl	ㅥ㜦
k^/tIG	ㅥ〠
k^/vR	ㅥ㉓
k^/vRd	ㅥ䌕
k^/vRz	ㅥ㤶
k^/zIn	ㅥ㤑
k^G/fu	匉劖
k^b	䆄
k^m	ぃ
k^m/fR/tx/bxl	ぃ㌅ㄱ㌆
k^m/fRt	ぃ䖆
k^m/px/ni	ぃ㔑㈕
k^mz	㝷
k^p	㝣
k^ps	䐀
k^t	㘕
ka/lIJ	䞇倡
ka/mEnt	䞇䒄
ka/mxn	䞇䚈
kak	䍗
kam/plI/ke/tId	䙲䙳〒㈑
kan/stInt/li	䝒刁㊄
kan/vR/se/SIn	䝒㉓ふ㥁
kar	㌀
kar/dI/nxl	㌀㔡䝇
kar/pIt	㌀䉓
kar/tun	㌀劓
kard	㘇
kard/bord	㘇儵
kardz	㘆
kart	㤀
karz	㠑
kc/fIG	㦑㠢
kc/fi	㦑㌖
kc/lIG	㦑㈨
kcf	䀄
kcl	㌕
kcld	䍑
kclm	䑑
kcr/nR	㈰㈱
kcrd	㉘
kcrdz	利
kcrn	㡳
kcst	匠
kct	㥔
kcz/bi	ㆂ゙
ke	〒
keJ	允
kek	㡹
keks	䄲
kem	㑩
ker	㍤
ker/fxl	㍤䁡
kerz	剨
kev	冐
ki	〴
ki/ki	〴〴
ki/pR	〴㌴
ki/txn	〴㕄
ki/txnz	〴䚗
kip	㚑
kips	㚒
kiz	㕑
kl@/pIG	㜐㐀
kl@p	㘒
klI/kIG	䙇へ
klIk	䀷
klIp	䑁
klIps	䘩
klIpt	䕱
klW/dIG	䍰ぴ
klW/di	䍰㈷
klWn	㙙
klWnz	偀
klWs	䤆
klY/mIG	㙳㙴
klY/mR	㙳㌶
klYm	㙲
klYmd	䚐
kl^k	䉣
klak	ㅤ
klc/zIt	㝀㝁
klcT	㝓
kli/nEks	䀁䀂
kli/nIG	䀁ㆉ
klin	㕣
klind	䄗
klinz	䠲
klir	䙑
klo/sR	䑘ㅓ
kloDz	㦓
klos	㜓
klozd	㊇
kluz	創
ko/cr/dI/ne/SIn	㉦㙣㔡䉥㥁
ko/kx	㉦㔧
ko/lx	㉦㘀
ko/stRz	㉦䉵
kol/dR	䘙㎓
kold	㐢
kom	刧
komd	䢂
kon	㘐
kors	䒅
kos/tR	㍂ㄔ
kot	㞈
kr@/bi	㢒゙
kr@/kR	㢒つ
kr@/kRz	㢒㢓
kr@G/ki	㥙〴
kr@G/ki/nEs	㥙〴䀙
kr@S	䅈
kr@b	倸
kr@k	䒔
kr@n/bE/ri	㡸ㄓㄢ
krI/sI/nIG	䍱㊃ㆉ
krI/smxs	䍱䍲
krI/stx/fR	䍱䠸㌅
krIG/kli	䁸䀁
krIb	䊘
krIs	䌰
krU/kxd	䡧䡨
krWd	䤣
krY	㑢
krY/IG	㑢と
krY/be/bi	㑢゘゙
krYd	䈧
kr^d	䝐
kr^n/Ci	㞒㞓
kr^nC	㥷
krc/lIG	䑖㈨
krc/lR	䑖㖕
krcl	㜵
krclz	偘
krcs	㐴
kre/zi	䖄㑤
krim	㘉
krip	䀤
kro/kx/sIz	䐢㔧㜁
kruz	䙓
kul	䊕
kuld	䢄
kw@k	䅙
kwEs/CIn	䡲㜗
kwI/vx/rIG	䆒㦇㙖
kwIk	㥧
kwIlt	倒
kwIt	㍓
kwY/It	䍨ㄙ
kwY/It/nIs	䍨ㄙ䉦
kwYt	㕖
kwel	䆓
kx/m@n/dR	㔧䀓㎓
kx/myu/nI/ke/SIn	㔧䄷㘷〒㥁
kx/ra/ti	㔧䠹〄
kx/t@s/trx/fi	㔧䕠䕡㌖
kxm/ple/nIG	㝴ㄣㆉ
kxm/plen	㝴㑷
kxm/plit/li	㝴偈㊄
kxm/pyu/tR	㝴㝵ㄔ
kxn/sRnd	䄔䕂
kxn/tEnt	䄔䑵
kxn/te/nR	䄔㌩㈱
kxn/tro/lR	䄔䔘㖕
kxn/trol	䄔䜵
kyu	㌥
kyu/k^m/bR	㌥ぃ㌂
kyu/ti	㌥〄
kyu/ti/pY	㌥〄㘖
kyut	㜶
l@/CIz	㠡㘳
l@/dR	㠡㎓
l@/fIG	㠡㠢
l@f	㠓
l@ft	䈡
l@m	䤅
l@mp	㉗
l@n/dIGz	䍀䍁
l@n/dId	䍀〸
l@nd	剓
l@p	䀣
l@p/fxl	䀣䁡
l@st	䔹
lE/mi	㐄〈
lE/mxn	㐄䚈
lE/tIG	㐄〠
lE/tIs	㐄㡂
lE/vxl	㐄㜇
lEf/ti	䕙〄
lEft	㑵
lEg	㑨
lEgz	㑧
lEs	㥰
lEt	㌉
lEts	ざ
lI/di/x	ち㈷べ
lI/kIG	ちへ
lI/li	ち㊄
lI/sI/nIG	ち㊃ㆉ
lI/sIn	ち䉇
lI/tR	ちㄔ
lI/tx/lR	ちㄱ㖕
lI/txl	ちぢ
lId	㍑
lIdz	㞃
lIft	䍹
lIk	㘢
lIn/dx	䝥㢈
lInt	䊆
lIp	倉
lIps	㤤
lIst	㠉
lIsts	䐇
lIz	䘨
lRn	䌹
lU/kIG	㈤へ
lU/kIt	㈤㖁
lU/ki	㈤〴
lUk	ぱ
lUks	㔥
lUkt	㐕
lUr	䚒
lW/di	䔡㈷
lWd	㍀
lY	䆃
lY/IG	䆃と
lY/tR	䆃ㄔ
lY/xn	䆃㑱
lY/xnz	䆃儲
lYd	㔣
lYf	㤵
lYf/se/vRz	㤵ふ㤶
lYk	ㅑ
lYks	䄒
lYn	㤣
lYnd	䤓
lYt	㖗
lYts	䚃
l^/ki	䉕〴
l^/vR	䉕㉓
l^/vi	䉕ゃ
l^k	㖓
l^n/Ci	䘳㞓
l^n/dxn	䘳䙱
l^nC	㐲
l^nC/tYm	㐲㉁
l^v	䀑
l^v/li	䀑㊄
l^vd	剐
l^vz	㘦
la	䀲
la/li	䀲㊄
la/li/pap	䀲㊄㡤
la/lx/la/lx/la	䀲㘀䀲㘀䀲
lab/stR	劅䀡
lak	㚂
laks	㚄
lakt	㥹
larJ	䦀
lat	㢖
lats	ㄳ
lc/rIns	䐵䐶
lc/rxz	䐵䤡
lcG	㑴
lcG/gIst	㑴䍤
lcG/gR	㑴㍔
lcn	㒑
lcn/dri	㒑㒒
lcr/di	䝈㈷
lcrd	䒓
lcst	䜀
le	ㅀ
le/IG	ㅀと
le/bxl	ㅀ㌆
le/di	ㅀ㈷
le/diz	ㅀ㐒
le/tR	ㅀㄔ
le/zi	ㅀ㑤
led	㝑
len	䈦
let	㠙
let/li	㠙㊄
li/mx	㊄㡵
li/nIG	㊄ㆉ
li/vIG	㊄㉕
li/vR	㊄㉓
lif	㡁
lin	䚘
lind	䈴
list	㥂
liv	㔁
livz	㜩
lo	ㄉ
lo/SIn	ㄉ㥁
lodz	䊈
lof	㤈
lu/sIn	㑓䉇
lu/zIG	㑓㑔
lus	儶
luz	㠳
m@/CIz	㔦㘳
m@/gi	㔦〆
m@/gx/zin	㔦䁉兠
m@/kx/ro/ni	㔦㔧㑑㈕
m@/kx/ro/ni/@nd/Ciz	㔦㔧㑑㈕ㄷ㤒
m@/mi	㔦〈
m@/mxlz	㔦䆆
m@/nIJ	㔦假
m@/nIJd	㔦䌠
m@/tR	㔦ㄔ
m@/trIs	㔦䢁
m@St	䘷
m@T/yu	剠〨
m@d	䑔
m@k	㙂
m@k/sxz	㙂㙃
m@ks	㉆
m@m	䥢
m@n	䀓
m@n/di	䀓㈷
m@n/diz	䀓㐒
mE/ZR	㘓䞑
mE/ZRz	㘓剦
mE/dI/sIn	㘓㔡䉇
mE/dxl/sxm	㘓㙓䌤
mE/ni	㘓㈕
mE/rI/li	㘓㕸㊄
mE/sIG	㘓ㅩ
mE/si	㘓ゔ
mEZ/x/rIG	䎙べ㙖
mEn	㌢
mEnt	䒄
mEs	㕀
mEst	㚆
mEt	䘗
mEts	䡂
mI/dxl	㄁㙓
mI/ki	㄁〴
mI/nIts	㄁㠲
mI/ni	㄁㈕
mI/niz	㄁䎐
mI/r@n/dx	㄁䄘㢈
mI/rR	㄁㄂
mI/sIG	㄁ㅩ
mI/sIz	㄁㜁
mI/si	㄁ゔ
mI/txnz	㄁䚗
mIk/sIG	䆅ㅩ
mIks	㡐
mIkst	䙂
mIl/ki	䘐〴
mIlk	㤘
mIs	ㅲ
mIs/tR	ㅲㄔ
mIs/tek	ㅲゐ
mIst	㘲
mR/si	㌶ゔ
mR/siz	㌶䉁
mW/DIG	䦂ゅ
mW/sIz	䦂㜁
mW/sxz	䦂㙃
mWT	㆘
mWnt	䙅
mWs	䅡
mY	〲
mY/gUd/nIs	〲ご䉦
mY/krx/fon	〲㑸㊓
mY/krx/fonz	〲㑸㙕
mY/nut	〲〳
mY/sElf	〲㔨
mY/ti	〲〄
mYk	䘈
mYks	倣
mYn	䝨
mYnd	䕴
mYs	䞄
mYt	䐱
m^/DR	䁙ㅉ
m^/DRz	䁙䁵
m^/Si	䁙㊀
m^/di	䁙㈷
m^/ni	䁙㈕
m^C	㑣
m^G/ki	䥧〴
m^S	㔩
m^St	䡀
m^g	刱
m^nC	㒅
m^nC/kIn	㒅㔅
m^nTs	䑳
m^s/tRd	㡔㡕
m^st	㍴
ma	ぅ
ma/ma/ma	ぅぅぅ
ma/mi	ぅ〈
ma/mi/xl	ぅ〈㝔
ma/miz	ぅㄗ
ma/mx	ぅ㡵
ma/mx/ma/mx	ぅ㡵ぅ㡵
ma/mxl	ぅ㘸
ma/mxz	ぅ䄈
ma/pxt	ぅ䥴
mam	㝈
mamz	䉉
man/stR	䀠䀡
mar/kIt	䚀㖁
mar/ni	䚀㈕
mark	䝀
mcr/gi	々〆
mcr/giz	々ㄥ
me	㑁
me/bi	㑁゙
me/kIG	㑁へ
me/x/nez	㑁べ㡒
med	䉙
mek	㐧
meks	䎀
mel	䚁
mel/baks	䚁㉸
men	兩
mi	〈
mi/W	〈ど
mi/di/xm	〈㈷㔇
mi/ko	〈㉦
mi/tIG	〈〠
mil	䌙
min	䌡
minz	䑉
mit	㡣
mo/R	ㆈ㑥
mo/bil	ㆈ䊙
mo/mInts	ㆈ倹
mo/nIG	ㆈㆉ
mo/tIv	ㆈ䍘
mo/tR/sY/kxl	ㆈㄔ㈐ㅔ
mo/zIz	ㆈ䜠
mod	䔸
mor	㉀
mor/gIn	㉀㊕
mor/gInz	㉀㉢
mor/nIG	㉀ㆉ
mos/tli	兵其
most	ㆄ
mu	㉩
mu/Sxz	㉩䈱
mu/kW	㉩䉃
mu/mu/Sxz	㉩㉩䈱
mu/ti	㉩〄
mu/vIG	㉩㉕
mu/vi	㉩ゃ
muS	䠇
mud	䘠
mun	䁅
mus	㉒
muv	㜸
muvd	䌨
muvz	䒃
mx/Sin	㡵䊃
mxk/da/nxld	䌈㞅偤
myu/zIk	䄷䄸
n@/Cx/rxl	㐥で倘
n@/nx	㐥〖
n@/pi	㐥㐦
n@U/zI	䤵㙰
n@p	㈹
n@p/kIn	㈹㔅
n@p/kInz	㈹㦄
n@p/s@k	㈹偱
n@p/tYm	㈹㉁
n@s/ti	偒〄
nE/sI/sE/ri	㐷㊃㍷ㄢ
nE/stIG	㐷㠠
nE/vR	㐷㉓
nEd	䍖
nEk	䌧
nEk/lIs	䌧㠴
nEkst	㞉
nEst	䥣
nI/kol	㘷䘙
nI/kx/lo/di/In	㘷㔧ㄉ㈷㄀
nI/li	㘷㊄
nI/pxl	㘷㜦
nIk	㐈
nO/zIz	䔖䜠
nO/zi	䔖㑤
nOz	㙔
nR/sx/ri	㈱㡇ㄢ
nRs	䙶
nW	ゆ
nY/sli	䕆㎙
nYfs	儇
nYn	㍩
nYn/tin	㍩䙧
nYs	㐤
nYt	㝩
nYt/nYt	㝩㝩
n^/TIG	㎕㈀
n^/^	㎕〷
n^/gIts	㎕劂
n^/mi	㎕〈
n^m	㌁
n^m/bR	㌁㌂
n^m/bRz	㌁䘄
n^m/n^m	㌁㌁
n^n	㡨
n^t	ㆃ
na/dIG	㍇ぴ
na/kIG	㍇へ
nak	㉷
nakt	䀀
nat	ㅗ
ncr/mxl	㡰㘸
ne	䉥
ne/bR/hUd	䉥㌂䘖
ne/bRz	䉥䘄
ne/kId	䉥䕔
nelz	䑂
nem	㉥
nemd	儣
nemz	䒘
ni	㈕
ni/dId	㈕〸
ni/no	㈕〘
ni/tIst	㈕䌘
ni/to	㈕㙆
nid	㌰
nidz	㍖
nil	䚅
nir	㥉
nir/bY	㥉㍆
nir/li	㥉㊄
nit	㙩
niz	䎐
no	〘
no/bx/di	〘ㆁ㈷
no/bx/diz	〘ㆁ㐒
no/no	〘〘
no/no/no	〘〘〘
no/tI/sIG	〘㚇ㅩ
no/tIst	〘䌘
no/wer	〘ㄒ
no/x	〘べ
no/xz	〘儥
non	䞘
nop	㖒
not	䘧
noz	㐱
nozd	㙄
nu	㉣
nu/bcrnz	㉣䆇
nu/dxl	㉣㙓
nu/dxlz	㉣㔳
nuz/pe/pR	㎗㌳㌴
o	】
o/SIn	】㥁
o/bi/ke/bi	】゙〒゙
o/gUd/nIs	】ご䉦
o/ke	】〒
o/ki/do/ki	】〴〵〴
o/mY/gUd/nIs	】〲ご䉦
o/px/nIG	】㔑ㆉ
o/pxn	】㆗
o/pxnd	】䍳
o/pxnz	】㝃
o/vR	】㉓
o/vR/clz	】㉓㜔
o/vxl	】㜇
ol/dR	䎒㎓
old	䌱
on	㌱
on/li	㌱㊄
ot/mil	䢐䌙
ots	㝥
p@/si/fYr	㝡ゔ㝢
p@/ti	㝡〄
p@/ti/kek	㝡〄㡹
p@/ti/o	㝡〄】
p@k	㤲
p@m/pR	䝙㌴
p@m/pRz	䝙㜂
p@n	㦘
p@n/dx	㦘㢈
p@n/tIG	㦘〠
p@nts	㑈
p@st	刉
p@t	䄄
pE/gi	㡃〆
pE/pR	㡃㌴
pE/pRz	㡃㜂
pE/tIG	㡃〠
pEG/gwIn	䔅䔆
pEg	䙐
pEn	㢅
pEp/si	㢑ゔ
pEs/ki	䜩〴
pEt	䜧
pI/gi	㔱〆
pI/giz	㔱ㄥ
pI/kIG	㔱へ
pI/kxl	㔱ㅔ
pI/kxlz	㔱㆓
pI/lo	㔱ㄉ
pI/loz	㔱䉔
pIGk	㉇
pIg	㈡
pIg/lIt	㈡㈢
pIk	㐇
pIk/CR	㐇㔢
pIk/CRz	㐇䤈
pIk/nIk	㐇㐈
pIkt	㐂
pIn	㡷
pIn/CIG	㡷㕴
pIn/to	㡷㙆
pInC	䉧
pOn/tIG	㕙〠
pOn/ti	㕙〄
pOnt	㕡
pOz/In/Is	䝂㄀䝃
pR/fEkt	㌴䕀
pR/fcr/mR	㌴〱㌶
pR/mI/SIn	㌴㄁㥁
pR/pxl	㌴㜦
pR/pxs	㌴儐
pR/sEnt	㌴㤙
pR/tI/kyx/lR	㌴㚇㍈㖕
pRl	䆑
pRs	傔
pU/SIG	㈧㝇
pU/lIG	㈧㈨
pUS	䀴
pUSt	兂
pUl	㌃
pUld	㑡
pUr	㈲
pUt	ぐ
pUts	㎂
pW/R	㔕㑥
pW/dR	㔕㎓
pW/ti	㔕〄
pWC	䐐
pWlz	㥣
pWn/dIG	倕ぴ
pY	㘖
pYl	㜆
p^/dxl/d^k	㆙㙓䁓
p^/nIS/mInt	㆙㞂䄶
p^/pIt	㆙䉓
p^/pi	㆙㐦
p^/pi/dcg	㆙㐦〡
p^/piz	㆙㔠
p^/tIG	㆙〠
p^/zxl	㆙䐁
p^f	䡴
p^m/pkIn	㦀㦁
p^mp/kInz	㦃㦄
p^nC	㜖
p^ps	儳
pa/kIt	㖀㖁
pa/kIts	㖀㖃
pa/lI/si	㖀ちゔ
pa/pY	㖀㘖
pa/p^p	㖀備
pa/px	㖀㔑
pa/pyx/lR	㖀䐅㖕
pa/sx/bxl	㖀㡇㌆
pa/tR	㖀ㄔ
pa/ti	㖀〄
pap	㡤
pap/sI/kxl	㡤㊃ㅔ
papt	儤
par/snI/pi	䘴䘵㐦
par/snIps	䘴䙁
park	䙠
part	䐒
pat	䂁
pat/hol/dR	䂁㕆㎓
pcz	䄣
pczd	䚔
pe	㌳
pe/CEk	㌳㕶
pe/IG	㌳と
pe/JIG	㌳䊗
pe/JIz	㌳㠵
pe/li	㌳㊄
pe/pR	㌳㌴
pe/pR/vyu	㌳㌴匓
pe/pRz	㌳㜂
peJ	䁒
per	㦖
perz	㡀
pi	㐦
pi/@/no	㐦㘶〘
pi/CIz	㐦㘳
pi/Jez	㐦䕷
pi/ka/Cu	㐦䞇㉖
pi/kx/bu	㐦㔧㙤
pi/n^t	㐦ㆃ
pi/n^ts	㐦䤤
pi/pi	㐦㐦
pi/pxl	㐦㜦
pi/sIz	㐦㜁
pi/tR	㐦ㄔ
pi/yu	㐦〨
pi/yu/stIG/ki	㐦〨㠠〴
piC	㦅
pip	䦑
pis	㜀
pit	䜉
piz	㔠
pl@/nIt	儰䉑
pl@n	䜶
pl@nt	䑓
pl@nts	㐐
pl@s/tIk	䎘䄖
plEn/ti	㤅〄
plW	㝕
pl^g	䄤
pl^gd	倗
pl^mz	㝧
pl^s	刑
ple	ㄣ
ple/IG	ㄣと
ple/R	ㄣ㑥
ple/hWs	ㄣ䍵
ple/pEn	ㄣ㢅
pled	䅀
plen	㑷
ples	㖑
plet	䝩
pliz	䀔
po/kIG	䅴へ
po/ki	䅴〴
po/ki/man	䅴〴䀠
pok	㝉
pol/kx/dat	䍄㔧䍅
por	䠐
porC	䘀
post	䤀
poz	䐕
pr@k/tI/sIG	䐦㚇ㅩ
pr@k/tIs	䐦㡂
prE/SIs	䐨䝔
prE/px/re/SIn	䐨㔑㠀㥁
prE/zIns	䐨䠂
prE/zInts	䐨䐩
prEs	㤩
prEst	䄢
prI/ti	ㅅ〄
prIns	䞙
prWd	偁
prYs	㤄
pra/bx/bli	㑐ㆁ㚕
pra/mIs	㑐ㅲ
pra/mIst	㑐㘲
prab/lxm	㥳㥴
pre	刢
prerz	倰
prez	䞂
prezd	䞃
pro/fY/lIG	冓䝸㈨
pruv	偆
prx/tEkt	䕉刘
prx/vEnts	䕉䕐
pu	䀹
pu/i	䀹〙
pu/pIz	䀹䄉
pu/pi/e	䀹㐦〦
pu/pu	䀹䀹
pul	䡕
pum/bx	匃ㆁ
pup/si	䤗ゔ
pup/si/bu	䤗ゔ㙤
pups	刴
px/Ja/mxz	㔑䊀䄈
px/ja/mxz	㔑䥀䄈
px/lYt	㔑㖗
px/lYt/li	㔑㖗㊄
px/pu	㔑䀹
px/re/dIG	㔑㠀ぴ
px/te/to	㔑㌩㙆
px/te/toz	㔑㌩㔒
px/tris	㔑䥄
px/zI/SIn	㔑㙰㥁
r@/DR	ㅆㅉ
r@/bIt	ㅆ㉑
r@/bIts	ㅆ䦄
r@/kun	ㅆㅇ
r@/kunz	ㅆ㉤
r@/txl	ㅆぢ
r@/txlz	ㅆ䆘
r@S	㚔
r@n	䄘
r@nC	劒
r@p	䁹
r@z/bE/ri	㘑ㄓㄢ
rE/JIs/tR	㈶㤨ㄔ
rE/dIG	㈶ぴ
rE/di	㈶㈷
rE/fyuJ	㈶䞆
rE/kRd	㈶䄦
rE/stIG	㈶㠠
rEd	ㅧ
rEk	䠈
rEk/t@G/gxl	䠈䡰㎇
rEst	㑇
rI/bxn	㕸剃
rI/frI/Jx/re/tR	㕸䅘㠸㠀ㄔ
rI/gx/li	㕸䁉㊄
rI/kcr/dIG	㕸㈰ぴ
rI/kcr/dId	㕸㈰〸
rI/kcr/dR	㕸㈰㎓
rI/kwYrz	㕸偢
rI/nud	㕸䠗
rI/pIG	㕸㐀
rI/siv	㕸刣
rI/vR	㕸㉓
rI/zIn	㕸㤑
rIC	剉
rIG	㙖
rIG/IG	㙖と
rIGz	䅁
rId	㒄
rImp	劃
rIns	䐶
rIp	儖
rIpt	儗
rIs/pans	䕲䕳
rUf	䍸
rUt	䤦
rW	䕩
rWnd	㎐
rY/dIG	㠶ぴ
rY/dRz	㠶䁲
rY/tIG	㠶〠
rY/ti	㠶〄
rYd	䍐
rYs	㔐
rYt	㌧
r^/SIG	㜅㝇
r^/bIG	㜅䌁
r^/bR	㜅㌂
r^/bx/ri	㜅ㆁㄢ
r^/fxl	㜅䁡
r^/nIG	㜅ㆉ
r^/ni	㜅㈕
r^/sxl	㜅䅱
r^S	䒀
r^b	㌠
r^f	䌢
r^n	㥤
r^nz	䡄
ra/bIn	䠹㍵
ra/bRts	䠹匑
rak	䌣
raks	䔶
rc/kIG/CEr	剰へ剱
rcG	㕹
re	㠀
re/IG	㠀と
re/di/o	㠀㈷】
re/lIG	㠀㈨
re/nIG	㠀ㆉ
re/nIT	㠀䞓
re/vInz	㠀䥅
re/zInz	㠀㢀
ren	㈥
ren/bo	㈥䖓
ren/dir	㈥㈦
ren/kot	㈥㞈
rend	䐤
renz	㘄
rez	䔙
ri/CIG	ㄢ㕴
ri/x/li	ㄢべ㊄
ri/x/renJ	ㄢべ㥃
ri/zIn	ㄢ㤑
riC	㙈
riCt	䈖
riT	䤇
ril	䠥
ro/dr^/nR	㑑㌵㈱
ro/lIG	㑑㈨
ro/li/po/li	㑑㊄䅴㊄
ro/mIG	㑑㙴
ro/vR	㑑㉓
rod	㥩
rol	㍙
rold	㐳
rolz	䉲
ror	匦
rost	䤸
rul	儘
rum	ㄦ
rus/tR	䆔ㄔ
rx/hab	㘩剁
rx/l@ks	㘩㘰
rx/mEm/bR	㘩㦂㌂
rx/mEm/bRz	㘩㦂䘄
rx/mYnd	㘩䕴
rx/mYndz	㘩㤔
rx/mot	㘩䔣
s@/lId	〇㍑
s@/mi	〇〈
s@/myu/xl	〇䄷㝔
s@/tIs/fY	〇㡂䝸
s@/tIs/fY/IG	〇㡂䝸と
s@d	䌲
s@l/ve/SIn	䞕䞖㥁
s@m/px/lIG	分㔑㈨
s@m/pxl	分㜦
s@n/dwIC	㡡㡢
s@n/tx	㡡ㄱ
s@nd/m@n	写䀓
s@t	㙦
sE/kxnd	㍷㑰
sE/kxndz	㍷䥱
sE/lx/ri	㍷㘀ㄢ
sE/sx/mi	㍷㡇〈
sE/txl	㍷ぢ
sE/txld	㍷䈳
sE/vIn	㍷㍸
sE/vIn/tin	㍷㍸䙧
sEd	え
sElf	㔨
sEn/dIG	䙴ぴ
sEn/tI/pid	䙴㚇倄
sEn/tR	䙴ㄔ
sEnd	㍢
sEns	偐
sEnt	㤙
sEt	㜷
sEz	㥱
sI/li	㊃㊄
sI/li/wI/li	㊃㊄㠃㊄
sI/ri/xl	㊃ㄢ㝔
sI/ri/xlz	㊃ㄢ㡦
sI/tIG	㊃〠
sI/ti	㊃〄
sI/vI/lYzd	㊃㡘偹
sIG	ㅩ
sIG/IG	ㅩと
sIGk	䔑
sId/niz	䎉䎐
sIk	䄕
sIks	㍹
sIks/tin	㍹䙧
sIl/vR	䠤㉓
sIl/vR/wer	䠤㉓ㄒ
sIn/drom	䉇劇
sIns	䄑
sIp	䀐
sIps	傂
sIs/tR	䕄ㄔ
sIs/txm	䕄䕅
sIt	〩
sIts	㙀
sR	ㅓ
sR/i	ㅓ〙
sR/kxl	ㅓㅔ
sR/kxlz	ㅓ㆓
sR/kxs	ㅓ䕢
sR/kyx/lR	ㅓ㍈㖕
sR/prY/zIG	ㅓ䆕㑔
sR/prYzd	ㅓ䔨
sR/txn/li	ㅓ㕄㊄
sR/vIs	ㅓ傃
sRCt	剙
sRv	䘹
sRvd	兰
sW/R	㤓㑥
sWnd	㈠
sWndz	㠔
sYd	㈓
sYd/wck	㈓し
sYn	䙹
s^/dxn/li	㙵䙱㊄
s^/kIG	㙵へ
s^/kR	㙵つ
s^/mR	㙵㌶
s^/mR/sclt	㙵㌶㙶
s^/mw^n	㙵㤷
s^/mwat	㙵䜥
s^/mwer	㙵䐸
s^/ni	㙵㈕
s^C	こ
s^b	先
s^k	䑣
s^ks	偗
s^m	ㄸ
s^m/TIG	ㄸ㈀
s^m/TIGz	ㄸ㔵
s^m/b^/di	ㄸ㒔㈷
s^m/hW	ㄸ㍉
s^m/ples	ㄸ㖑
s^m/tYmz	ㄸ䜆
s^m/w^nz	ㄸ䀖
s^n	䀰
s^n/SYn	䀰䤂
s^n/gl@/sIz	䀰䁁㜁
s^nz	傓
s^p/lx/mInt	䠔㘀䄶
sa/ki	ㄡ〴
sa/nIk	ㄡ㐈
sa/ri	ㄡㄢ
sak	㚐
saks	㜄
sc	㐸
sc/gi	㐸〆
scG	䀢
scf/tIst	䜱䌘
scft	䄱
scft/li	䄱㊄
scl/sx	㤕㡇
scrt	倈
scrts	㖂
scs	㝱
se	ふ
se/IG	ふと
se/vIG	ふ㉕
sef	儓
sem	㕇
sev	䑈
sevd	儉
si	ゔ
si/IG	ゔと
si/g^lz	ゔ䖘
si/mIG/li	ゔ㙴㊄
si/sc	ゔ㐸
si/zInz	ゔ㢀
sid	䚑
sidz	䚓
sil	㙠
silz	㙡
sim	兙
simz	䄡
sin	䠙
sinz	匄
sit	㠥
sits	䅒
siz	䉁
sk@m/pR	䦙㌴
skE/JUl	㥄㥅
skEl/tR	刷ㄔ
skR/ri	倀ㄢ
skY	䄅
skcr/pi/In	䆖㐦㄀
skel	儠
sker	㘤
skerd	㑉
skord	䡃
skr@/CIG	㕳㕴
skr@C	䑥
skr@Ct	䡣
skr^/bi	儅゙
skr^b	児
skr^m/pSIs	兲关
skre/pIG	䒗㐀
skri/mIG	㠰㙴
skrim	䜁
skrin	䔦
skul	䅑
skul/hWs	䅑䍵
skup	䠑
skut	䡷
skw/Rrxl	䆈䆉
skwI/Si	充㊀
skwIS	傇
skwISt	傈
skwR/mIG	㦔㙴
skwR/mi	㦔〈
skwR/rxlz	㦔㦕
skwR/tIG	㦔〠
skwR/x/li	㦔べ㊄
skwR/x/liz	㦔べ㠒
skwRm	䐣
skwaS	㝰
skwc/Si	㝸㊀
skwc/Siz	㝸㆐
skwer	㎃
skwi/kR	䕹つ
skwi/ki	䕹〴
skwik	䍉
skwiks	䐓
skwiz	䑧
sl@pt	䔔
slI/pR	䉄㌴
slI/pRz	䉄㜂
slI/px/ri	䉄㔑ㄢ
slIG/ki	䅕〴
slIp	㥘
slR/pIG	䑅㐀
slY/dIG	䌄ぴ
slY/mi	䌄〈
slYd	䁩
sl^m/bR	偕㌂
sl^m/bRz	偕䘄
sla/bx/rIG	䔴ㆁ㙖
sla/pIG	䔴㐀
slaS	偨
slab	䢀
slat	儩
sli/pIG	㎙㐀
sli/pR	㎙㌴
sli/pi	㎙㐦
sli/piz	㎙㔠
slip	㠘
slit	㠕
sliv	㔹
slivz	䙸
slo	㠖
slo/li	㠖㊄
sm@/SIG	倨㝇
sm@k	冀
smE/lIG	䦇㈨
smEl	䝘
smElz	㔙
smY/lIG	㤸㈨
smY/li	㤸㊄
smYl	䈷
smYld	䈢
sm^S	䙕
sm^St	䙖
smart	䙀
smc/lR	㖔㖕
smcl	䖗
smok	䤕
smu/DR	䍂ㅉ
sn@/pi	䜈㐦
sn@C	䔰
sn@Ct	兤
sn@k	㠧
sn@ks	偰
sn@p	㎀
sn@ps	㑠
sn@pt	㚈
sn^/gxl	䎔㎇
sn^g	䂕
sncr/tIG	㈙〠
sne/ki	儹〴
sni/ki	䥶〴
sniz	㕁
sno	䜐
sno/IG	䜐と
sno/i	䜐〙
sno/m@n	䜐䀓
sno/sut	䜐儴
snups	䘶
so	㈈
so/IG	㈈と
so/IG/mx/Sin	㈈と㡵䊃
so/dx	㈈㢈
so/fx	㈈䕸
so/kIG	㈈へ
sold	剑
sop	䀆
spE/Sxl	㍃䑦
spEk/trxm	匙䔠
spEnd	値
spI/lIG	䌉㈨
spI/nIG	䌉ㆉ
spI/rIt	䌉䁄
spI/tIG	䌉〠
spIl	儙
spIld	億
spIn	䁤
spInz	儂
spIt	䌓
spWt	䀨
spY/IG	䀧と
spY/dR	䀧㎓
sp^d	ゖ
spat	䔉
spats	䠱
spes	冉
spi/kIG	䜘へ
spidz	倅
spik	䌥
spl@S	䂑
spl@St	䡠
splI/Si/spl@/Si	䡇㊀䡈㊀
splIS/spl@S	偲䂑
splIt	䜨
spok	剅
sprEd	䢘
sprIG	䍢
sprIGz	䉡
spre	儑
spun	㔂
spun/fxlz	㔂䥂
spunz	傁
spx/gE/ti	倢㙧〄
st@k	㍱
st@kt	兄
st@n/dIG	びぴ
st@n/dpOnt	び刓
st@nd	㌦
st@ndz	䔈
stE/di	䔐㈷
stE/ri/o	䔐ㄢ】
stEd/f@st	䌑㚓
stEp	䁧
stEps	㖖
stEpt	䜔
stI/kIG	䚆へ
stI/ki	䚆〴
stIG/kR	㠠つ
stIG/ki	㠠〴
stIGk	偔
stIk	䄆
stIks	䈉
stIl	㍗
stIn/Ji	劁㜴
stUd	㖈
stY/lIG	冒㈨
stYl	㡲
st^/di/IG	䌇㈷と
st^/fi	䌇㌖
st^/mxk	䌇䌈
st^f	を
st^ft	㘵
st^k	㝄
stam/pIG	䒕㐀
stamp	䄁
stap	䍣
staps	䙵
stapt	䔕
star	㎅
star/tIG	㎅〠
star/tId	㎅㈑
star/vIG	㎅㉕
start	㝆
starts	䥗
starz	㍨
ste	㘂
ste/IG	㘂と
ste/rIG	㘂㙖
sted	䡶
stek	劄
sten	䉒
sterz	ん
stil	㞕
stir	㜹
sto/ri	䁃ㄢ
stor	㡄
str@p	㎈
str@pt	㝶
strE/CIG	䈓㕴
strE/CIz	䈓㘳
strEGk/Tx/nIG	䕗䕘ㆉ
strEGkT	䝣
strIG	䑢
strIGz	䙣
strYpt	㍧
strc/bE/ri	偶ㄓㄢ
strcG	㎖
strenJ	䊓
stret	㥥
strim	偠
strit	㥲
strit/lYt	㥲㖗
stro/lR	䘑㖕
stu	㆑
stu/pId	㆑㆒
su/pR/m@n	劐㌴䀓
sun	䄀
sus	䍦
sut	儴
swE/tR	䀇ㄔ
swE/tSRt	䀇䀈
swEt/p@nts	㜙㑈
swI/mIG	刵㙴
swIC	䚂
swIG	䈙
swIG/IG	䈙と
swIGz	䙔
swIS	䁱
swIm	䂃
swIm/sut	䂃儴
swUS	䈈
swa/lo	䌐ㄉ
swi/pIG	㐙㐀
swi/tIst	㐙䌘
swi/t^mz	㐙剡
swi/ti	㐙〄
swi/ti/Est	㐙〄剣
swi/ti/pY	㐙〄㘖
swi/ti/pYz	㐙〄剩
swip	䙩
swit	㡅
swit/hart	㡅㤥
swits	刨
sx/pozd	㡇㡈
sx/spEn/dRz	㡇䘢䁲
sxk/sEs/fx/li	刕刖䕸㊄
sxs/pEn/dR	䖂㢅㎓
t@/bI/Tx	㝹㒃䕘
t@/bI/Txz	㝹㒃䥤
t@/nIS	㝹㞂
t@/pi/o/kx	㝹㐦】㔧
t@G/gxld	䡰䡱
t@Gk	䐉
t@d	䕁
t@g	傑
t@k/si	䑤ゔ
t@m/bx/rin	䐘ㆁ䐙
t@n/Jx/rinz	㠷㠸㠹
t@n/trxm	㠷䔠
t@p	䦈
t@z	偖
tE/di	㒓㈷
tE/lIG	㒓㈨
tE/lx/fon	㒓㘀㊓
tE/lx/fonz	㒓㘀㙕
tE/lx/t^/bi	㒓㘀䄃゙
tE/lx/t^/biz	㒓㘀䄃㔗
tE/nIs	㒓䉦
tE/ri	㒓ㄢ
tE/rx/bxl	㒓㘩㌆
tEk/nI/kxl	䚙㘷ㅔ
tEl	䁂
tEn	㍦
tEnt	䑵
tEr	䁰
tErz	䐥
tI/Su	㚇ぉ
tI/di/wIG/kxl	㚇㈷䉈ㅔ
tI/gR	㚇㍔
tI/gRz	㚇䉗
tI/ki	㚇〴
tI/klR/	㚇䜃
tI/kx/lIG	㚇㔧㈨
tI/kxl	㚇ㅔ
tI/kxl/I	㚇ㅔ㉈
tI/kxl/IS	㚇ㅔ䑙
tI/kxl/tI/kxl	㚇ㅔ㚇ㅔ
tI/kxlz	㚇㆓
tI/mi	㚇〈
tI/miz	㚇ㄗ
tI/mon	㚇匂
tI/mx/Ti	㚇㡵䙉
tI/pIG	㚇㐀
tI/pi/to	㚇㐦㙆
tIG/ki	〠〴
tIlt	偸
tIm	䅐
tIm/bR	䅐㌂
tImz	䥃
tIp	䍶
tIp/toz	䍶㔒
tIpt	䜰
tO	㍁
tO/baks	㍁㉸
tO/lIt	㍁㈢
tOz	ㅄ
tR/ki	ㄔ〴
tR/nIG	ㄔㆉ
tR/txlz	ㄔ䆘
tRn	㍡
tRnd	㙥
tSI@/rI/@U	䡡㕸䡢
tUS	倔
tUk	㎉
tUt/si	䢓ゔ
tUt/siz	䢓䉁
tW/R	䅇㑥
tW/Rz	䅇㜨
tWl	ぶ
tWlz	䊄
tWn	䁥
tY	㞐
tY/gR	㞐㍔
tY/mIG	㞐㙴
tY/ni	㞐㈕
tY/pIG	㞐㐀
tY/ris	㞐䡥
tYd	剂
tYm	㉁
tYmz	䜆
tYrd	㈵
tYt	㍒
t^/CIG	䄃㕴
t^/Ci	䄃㞓
t^/mi	䄃〈
t^/pR/wer	䄃㌴ㄒ
t^C	䀶
t^Ct	䈤
t^G	䄇
t^b	㌣
t^f	䖕
t^g	㜢
t^k	䥷
t^m/bx/lIG	䆗ㆁ㈨
t^m/bxld	䆗䈕
t^nz	偅
tam	䥵
tap	㌹
tarts	㡥
tc/kIG	ぷへ
tc/kR	ぷつ
tc/kx/tIv	ぷ㔧䍘
tc/sIz	ぷ㜁
tck	㠆
tcl	㍲
tct	䌦
te/bxl	㌩㌆
te/bxl/klcT	㌩㌆㝓
te/kIG	㌩へ
te/stIG	㌩㠠
te/tRz	㌩䀅
tek	ゐ
teks	㎁
tel	䜦
telz	䉠
tep	㕷
tep/mE/sUr	㕷㘓剥
tept	䝉
tes/ti	ㅈ〄
test	䊔
tests	䙃
ti	〄
ti/DIG	〄ゅ
ti/Tiz	〄䢑
ti/ni	〄㈕
ti/ni/wi/ni	〄㈕ㅁ㈕
ti/pi	〄㐦
ti/piz	〄㔠
tiC	䝲
tiT	䄨
tim	䤧
tin/si	䙧ゔ
to	㙆
to/sti	㙆偳
to/tx/li	㙆ㄱ㊄
told	䐄
tord	儈
tordz	䝰
toz	㔒
tr@/fIk	㥡㥢
tr@S	䔩
trIk	㌸
trIp	㞙
trY	㍠
trY/@G/gxl	㍠㎆㎇
trY/@G/gxlz	㍠㎆䉅
trY/IG	㍠と
trYd	䐧
tr^/bxl	㜥㌆
tr^Gk	䈘
tr^k	䤃
tr^st	偷
tre	䀒
tre/nIG	䀒ㆉ
tren	㦗
tri	䈗
tri/tap	䈗㌹
trit	䘲
triz	䎇
tru/li	䒐㊄
truT	列
trx/piz	䕡㔠
tu	ら
tu/@nd/fro	らㄷ㤐
tu/Ti	ら䙉
tu/nx	ら〖
tuT	䄰
tuT/br^S	䄰䄧
tul	䘉
tulz	䘃
tut	䥔
twElv	䢙
twEn/ti	㚁〄
twI/stIG	䔲㠠
twIG/kxl	䢆ㅔ
twIs/tR	䖃ㄔ
twIs/ti	䖃〄
twY/IG	䝓と
twi/ti	䥰〄
twit	䥥
tx/de	ㄱㄶ
tx/gE/DR	ㄱ㙧ㅉ
tx/ma/ro	ㄱぅ㑑
tx/ma/roz	ㄱぅ䂖
tx/nYt	ㄱ㝩
u	㠩
up	䀕
up/si	䀕ゔ
ups	㞇
v@/kyum	䑸䑹
vE/ri	ㆅㄢ
vEJ/tx/bxl	㔃ㄱ㌆
vEJ/tx/bxlz	㔃ㄱ㔈
vEl/kro	䐡䐢
vEnt	䔳
vI/di/o	㡘㈷】
vI/nx/gR	㡘〖㍔
vI/zI/tIG	㡘㙰〠
vI/zIt	㡘㝁
vOs	㑕
vY/tx/mIn	刦ㄱ䥸
v^z	割
vi	ゃ
vi/I/kxl	ゃ㉈ㅔ
viz	䒑
vol	䈀
vrum	䤑
vx/rY/I/ti	㦇㠶㉈〄
w@/w@/w@	䁴䁴䁴
w@g	䥉
wE/DR	䜗ㅉ
wEb	䈁
wEl	ㆇ
wEl/kxm	ㆇ㝴
wEn	㍅
wEnt	ㅘ
wEnz/de	䡹ㄶ
wEt	㑃
wEw	儱
wI/DWt	㠃㠄
wI/SIz	㠃㝙
wI/gxl	㠃㎇
wI/gxlz	㠃䉅
wI/li	㠃㊄
wI/mIn	㠃䥸
wI/ni	㠃㈕
wI/spRd	㠃䈶
wI/spx/rIG	㠃倢㙖
wIC	㒐
wID	ㄤ
wIG/ki	䉈〴
wIG/kxl	䉈ㅔ
wIS	㤆
wIl	ㅢ
wIn	㐖
wIn/di	㐖㈷
wIn/do	㐖〵
wIn/doz	㐖䁨
wIn/tR	㐖ㄔ
wInd	㠇
wInd/Sild	㠇㠈
wIt/ni	䘘㈕
wR	㐶
wR/SIp	㐶䝶
wR/kIG	㐶へ
wR/krum	㐶䉹
wR/ri	㐶ㄢ
wRdz	䔇
wRk	ㅙ
wRks	㢐
wRkt	䜂
wRld	䌅
wRnt	㑦
wU/dxnt	㌇㌈
wU/li	㌇㊄
wU/mxn	㌇䚈
wU/pi	㌇㐦
wUd	㌄
wUf	健
wUf/wUf	健健
wUlf	倳
wUp/si	㥆ゔ
wUp/sx/de/zi	㥆㡇ㄶ㑤
wW	㍣
wY	㉹
wY/li	㉹㊄
wY/ni	㉹㈕
wY/ni/nEs	㉹㈕䀙
wY/pIG	㉹㐀
wY/pRz	㉹㜂
wYd	㆖
wYf	儦
wYl	㒖
wYld	䂄
wYn/dR	刹㎓
wYp	㕢
wYps	㑒
wYr	䐗
wYrz	兀
wYt	㉐
w^/ni	㍳㈕
w^/tId	㍳㈑
w^/zInt	㍳㉉
w^/zi	㍳㑤
w^n	ㆆ
w^n/dR	ㆆ㎓
w^n/dR/fxl	ㆆ㎓䁡
w^n/si	ㆆゔ
w^n/tIG	ㆆ〠
w^n/tId	ㆆ㈑
w^ns	䝁
w^nt	ㅹ
w^nts	〉
w^nz	䀖
w^t	〣
w^t/E/vR	〣ㄐ㉓
w^ts	〔
w^z	〤
wa/CIG	぀㕴
wa/CIz	぀㘳
wa/nx	぀〖
waC	㕱
waCt	㉳
wan/dRd	入䐃
wan/dx/rIG	入㢈㙖
wc/SIG	ㄩ㝇
wc/kIG	ㄩへ
wc/kR	ㄩつ
wc/ki	ㄩ〴
wc/rir	ㄩ䠘
wc/tR	ㄩㄔ
wc/tR/fcl	ㄩㄔ㑗
wc/tR/mE/lxn	ㄩㄔ㘓䌂
wc/tRz	ㄩ䀅
wc/tx/ri	ㄩㄱㄢ
wcS	㊐
wcS/klcT	㊐㝓
wcS/klcTs	㊐䊅
wcSt	䀩
wck	し
wckt	䕣
wcl	䎅
wcr	㜣
wcr/mIG	㜣㙴
wcr/mR	㜣㌶
wcr/nIG	㜣ㆉ
wcrm	㝲
wcrmd	䌀
we	㉔
we/kIG	㉔へ
we/rE/vR	㉔㈶㉓
we/rIG	㉔㙖
we/stIG	㉔㠠
we/tIG	㉔〠
we/vIG	㉔㉕
wek	䅠
wel	䂇
wer	ㄒ
werd	䄴
werz	㄃
west	䡙
wet	㠐
wev	㤹
wevz	䂒
wez	㘔
wi	ㅁ
wi/kEnd	ㅁ䊑
wi/vIG	ㅁ㉕
wi/wi	ㅁㅁ
wi/wi/wi/wi	ㅁㅁㅁㅁ
wi/wiz	ㅁ䜅
wiks	剤
wil	㊒
wilz	䁇
win/si	䀦ゔ
wir	ょ
wird	䜖
wit	㔓
wiv	㑂
wo	ㄖ
wo/sut	ㄖ儴
wok	䥲
wont	㈔
wor	刄
wups	㎄
x/bWt	べむ
x/b^v	べ䂆
x/dor	べ㊆
x/fEn/sIv	べ䜢㢆
x/fred	べ䝳
x/gEn	べㄅ
x/gEnst	べ䙈
x/go	べぇ
x/grE/sIv	べ劉㢆
x/gri	べ㔷
x/hEd	べ㈆
x/klak	べㅤ
x/krcs	べ㐴
x/lE/vIn	べ㐄㍸
x/lW	べ䔡
x/lWd	べ㍀
x/lY/Jx	べ䆃㠸
x/lYv	べ䝕
x/lcG	べ㑴
x/li/Sxz	べ㊄䈱
x/lon	べ䐑
x/mE/rI/kx	べ㘓㕸㔧
x/mWnt	べ䙅
x/m^G	べ䥧
x/me/zIG	べ㑁㑔
x/me/zIG/li	べ㑁㑔㊄
x/myu/zIG	べ䄷㑔
x/n^/DR	べ㎕ㅉ
x/pI/nyIn	べ㔱共
x/part	べ䐒
x/pcn	べ䑶
x/pe/rInt/li	べ㌳儧㊄
x/rWnd	べ㎐
x/rYz	べ䠖
x/slip	べ㠘
x/sumd	べ刀
x/t@C	べ䙗
x/t@k	べ䑤
x/t@kt	べ冈
x/tEn/SIn	べ㍦㥁
x/we	べ㉔
xb/sEst	内円
xl/tI/ri/R	㝔㚇ㄢ㑥
xm	㔇
xm/brE/lx	㔇㖙㘀
xm/hxm	㔇㕗
xm/ke	㔇〒
xmz	则
xn/h@/pi	㑱㉱㐦
xn/k^/vx/rIG	㑱ㅥ㦇㙖
xn/lI/mI/tId	㑱ち㄁㈑
xn/plE/zInt	㑱䕵㉉
xn/pl^g	㑱䄤
xn/tIl	㑱㑲
xn/tY	㑱㞐
xn/zIp	㑱㖅
xp/sterz	㒂ん
y@Gk	䑄
yE/lIG	ㅨ㈨
yE/lo	ㅨㄉ
yEl	䍧
yEp	㥑
yEs	㉶
yEs/tR/de	㉶ㄔㄶ
yEt	㉴
yR	〶
yR/lIG	〶㈨
yU/rx/pi/In	㡑㘩㐦㄀
yUr	゗
yUr/sElf	゗㔨
yUrz	䔀
y^/kE/ti/y^k	㌘㡖〄䑆
y^/ki	㌘〴
y^/kx	㌘㔧
y^/mi	㌘〈
y^/my^m	㌘㕐
y^/my^mz	㌘删
y^G	冇
y^k	䑆
y^m	㒁
y^p	㖄
ya	㐡
ya/ya	㐡㐡
ya/ya/ya	㐡㐡㐡
yan/dR	䂈㎓
yard	䑴
yc/nIG	䈂ㆉ
ycn	䉐
ye	㕲
yir	別
yirz	刔
yo/gRt	倵儃
yo/yo	倵倵
yu	〨
yu/Zu/xl	〨䒇㝔
yu/i	〨〙
yu/nIt	〨䉑
yu/zIG	〨㑔
yuZ/u/x/li	㠨㠩べ㊄
yud	䌔
yul	䂙
yur	げ
yus	㘁
yuv	㚙
yuz	䢅
yuzd	倶
zI/pR	㙰㌴
zI/pRz	㙰㜂
zIg/z@/gIG	䈃䈄䈅
zIp	㖅
zIpt	䚇
zev/yR	兦〶
zi	㑤
zi/brx	㑤䈆
zi/ro	㑤㑑
zu	兆
zum	䤔