@	【
@G	㈆
@S	㌑
@U	㤵
@b	〗
@d	ひ
@dz	へ
@f	㄁
@g	ㄑ
@k	〳
@ks	㍢
@kt	じ
@kts	ば
@l	ㄳ
@m	ㅸ
@n	㆕
@nd	㆘
@nt	㈨
@nts	㈴
@nz	啀
@sk	㌓
@sks	㌖
@skt	㌔
@t	㌲
@v	㍒
@z	㌈
C@	㤇
C@ns	㤉
C@nt	㤐
C@p	㤓
C@t	㤥
CE	㤧
CEk	㤦
CEks	㤩
CEr	儓
CErz	儔
CEst	㥃
CI	㤶
CIG	㖒
CIf	匶
CIfs	偄
CIk	㥇
CIks	㥈
CIl	㥔
CIm	㥘
CImp	㥙
CIn	㥡
CInt	㆗
CInz	榈
CIp	㥣
CIps	㥥
CIr	楳
CIs	怦
CIz	㊁
CO	㥰
COs	㥩
CR	を
CRC	㦐
CRd	愶
CRp	㥦
CRz	䈑
CY	㥢
CYld	㥓
CYm	㥖
CYmz	㥗
C^	㦈
C^G	㦉
Cak	㤅
Camp	㥵
Cap	㥷
Capt	㥸
Car	㤙
CarJ	㤗
CarJd	㤘
Carm	㤡
Cart	㤢
Cc	㥨
Cck	㤄
Ccr	极
Ccrz	㦀
Ce	㢘
Cen	㤀
CenJ	㤑
CenJd	㤒
Cenz	㤁
Cer	㤂
Cerz	㤃
Ces	㤣
Cest	㤤
Ci	え
Cik	㤰
Ciks	㤱
Cip	㤲
Cir	㤳
Cirz	㤸
Civ	ぅ
Civd	う
Civz	ぇ
Ciz	㤹
Co	㥲
Cok	㥱
Cor	㥹
Coz	㦁
Cu	ぐ
Cud	㥄
Cuk	㥶
Cuz	㥅
Cx	㢕
Cxnd	唦
Cxnz	唧
Cxp	匷
Cxz	㦑
D@	栕
D@n	栉
D@t	栔
D@ts	儱
DEm	栢
DEmz	栣
DEn	栥
DIG	㑥
DIn	焳
DIs	桁
DR	ㅵ
DRd	㙨
DRz	㙩
DWt	焴
DY	档
D^	栗
De	栧
Ded	栨
Del	栩
Der	栠
Derz	校
Dev	栰
Di	栘
Diz	栦
Do	ㅳ
Doz	桅
Dx	㈤
Dxm	愰
E	㈵
EJ	䕀
Ed	䕂
Ef	〇
Eg	㞉
Egz	䕈
Ek	〨
Eks	䘢
El	䕑
Els	䕱
Elvz	䕲
Em	䕴
En	䖀
End	䖂
Endz	䖃
Er	ㄩ
Es	䘀
Est	さ
Ev	䘐
GR	假
I	䕒
IC	剨
IG	㈙
IGk	制
IGz	㔦
IJd	䖁
IS	䥲
IT	䜐
Idz	䝷
If	刓
Ig	䘗
Ik	䘱
Iks	䘤
Il	刖
Im	刘
In	぀
InC	別
Ins	䘳
Int	䐇
Inz	䌙
Irz	䔦
Is	䤖
Ist	䔴
It	䍰
Its	剥
Iz	剡
J@	剰
J@k	剱
J@ks	割
J@m	剸
J@z	劅
JE	㈄
JEf	劐
JEfs	劑
JEk	悙
JEkt	妘
JEkts	妙
JElz	䢃
JEn	䢆
JEnt	䢇
JEnts	䍖
JEs	䄓
JEst	朘
JI	㔳
JIG	㌃
JIS	坔
JIg	劘
JIk	唔
JIks	圙
JIkt	朆
JIl	劙
JIm	倢
JImz	匀
JIn	䕶
JInd	吗
JInt	䍕
JInz	塰
JIs	䥄
JIt	㜡
JIz	㜘
JO	䖅
JOd	䖆
JOn	匆
JOs	愀
JOz	䖇
JR	刵
JRk	劓
JRz	攄
JU	䕁
JUl	戙
JY	䢓
J^	べ
J^G	匠
J^Gk	匢
J^J	匐
J^g	匑
J^m	匓
J^mp	匕
J^mps	北
J^mpt	化
J^s	め
J^st	ゃ
J^t	匣
Ja	匃
Jab	匁
Jag	匂
Jan	匄
Janz	包
Jar	劂
Jard	劃
Jarz	劄
Jc	劆
Jcr	䢉
JcrJ	䢈
Jcz	劇
Je	儗
Jek	剷
Jel	剶
Jemz	剹
Jen	劀
Jenz	劁
Jez	剩
Ji	〈
Jin	䢄
Jinz	劈
Jits	㜢
Jiz	劉
Jo	㐦
Jok	匇
Ju	䥕
Jul	劗
Jun	匘
Junz	匙
Jus	匒
Jx	㕃
Jxl	㈃
Jxld	戠
Jxlz	㈅
Jxz	㤠
OG	圶
OGk	圵
Ol	圳
Old	圴
On	圸
Os	垀
R	㡹
RJ	榉
RT	䔲
Rn	剗
Rnd	䔨
Rnz	剠
Rrxl	昐
Rz	䝳
S0	入
S@	恩
S@l	折
S@m	持
SE	挔
SEf	㥁
SEl	挘
SElf	挙
SElz	托
SI	䄈
SIG	㝕
SIft	挢
SIfts	挣
SIn	だ
SInd	䉣
SIns	堠
SInt	堡
SInts	堢
SInz	䉤
SIp	愁
SIps	挦
SIs	ㆄ
SIz	㌐
SR	䐂
SRt	嚖
SRts	挧
SU	捂
SUd	捁
SUk	挳
SUr	朣
SUrd	悅
SW	捆
SWt	捅
SY	挥
SYn	挤
S^	捉
S^t	捖
S^v	捇
S^vd	捈
Sa	挵
Sad	挰
Sak	挨
Sakt	挩
Sap	挴
Sark	指
Sarks	挈
Sarp	按
Sat	挹
Sats	捀
ScG	攓
Scn	払
Scr	挷
Scrt	挶
Scrts	挸
Se	抔
Sed	抒
Sedz	抓
Sek	投
Seks	抗
Sekt	抖
Sem	挀
Semd	㌉
Sep	挂
Seps	挄
Sept	挃
Ser	挅
Serd	挆
Sev	挐
Sez	㌶
Si	㉧
Sid	挑
Sil	挒
Sild	挡
Sildz	焣
Sin	唈
Sinz	唉
Sip	挕
Sird	挓
Sit	挖
Sits	挗
Siz	䜳
SmE	商
SmuS	嘣
Sn^ks	戡
So	怰
Sod	捒
Sol	捄
Sor	扙
Soz	捓
Sr@g	䐁
Srum	噘
St	極
Su	匉
Sut	㦒
Suz	挱
Sx	㙕
Sxl	㈳
Sxlz	䂑
Sxn	㌨
Sxnd	啶
Sxnz	䄘
Sxs	㝗
Sxz	ㅑ
T@G	栒
T@Gk	栐
T@Gks	栓
T@Gkt	树
TI	栲
TIG	㉀
TIGk	栶
TIGks	样
TIGz	䘓
TIf	栙
TIk	栱
TIn	栵
TR	㌆
TRd	核
TRs	桀
TRst	根
TRz	栀
TW	桇
TY	栳
TYz	栴
T^m	桙
T^mz	桠
T^n	桢
Tc	栖
Tcr	桄
Tcrn	桂
Tcrnz	桃
Tct	框
Ti	㑤
Tiz	栁
Tr@	桐
Tr@S	桉
TrEd	桑
TrIn	匩
Tri	桒
Triz	桓
Tro	劖
Tron	桗
Trot	桕
Trots	桖
Troz	桘
Tru	桔
Trum	㑨
Trumz	㑩
Tu	䖑
Tx	啇
Txd	喁
Txn	噲
Txz	㕈
W	冀
WC	坥
WE	内
WEns	炇
WIps	炗
WIpt	炖
WRz	䝲
WW	坹
WYnd	炒
WYnz	炓
W^t	炂
War	冄
Wi	坴
Wil	炄
Wl	坵
Wlz	坷
Wn	坨
Wns	坧
Wt	坩
Wx	䆆
Wxlz	坶
Y	㍣
Yd	䥁
Yg	䙈
Yl	ㄱ
Ylz	ㄲ
Ym	刉
Yr	剙
Yrnd	剘
Ys	刑
Yv	刐
Yz	䙑
ZIn	䘹
ZR	啧
ZRz	䤃
Zi	䢙
Ziz	䤀
Zu	概
^	䕗
^G	楴
^bz	楱
^g	楲
^m	㊕
^n	坄
^p	㘕
^ps	榇
^s	榐
^t	榔
^v	在
^z	㈀
a	。
ab	團
ad	圧
af	地
ak	圤
an	䈆
and	㕖
anz	䈇
ap	坈
apCG	坒
ar	㊀
arg	㊇
ark	㉹
arm	㊑
armz	㊗
arnt	㊄
art	㌅
arts	㌇
arz	䙒
as	坢
b@	㍰
b@G	㐢
b@Gd	㐣
b@Gk	㐧
b@S	㑒
b@T	㑣
b@Ts	㑰
b@d	㎔
b@g	㎕
b@gz	㎗
b@k	㎂
b@ks	㎉
b@kt	㎄
b@l	㐂
b@m	㐖
b@n	㐥
b@nd	㐘
b@ndz	㐡
b@ps	㐩
b@s	㑖
b@t	㑢
b@ts	㑳
bE	㑆
bET	㕓
bETs	䕨
bEd	㔁
bEdz	㔂
bEg	㔔
bEl	㔨
bElC	㔧
bElt	㔶
bElts	㔷
bElz	㐱
bEn	㔸
bEnC	㕀
bEnd	㕁
bEnt	㕅
bEnz	㔹
bErr	㒅
bErz	㒄
bEst	㕑
bEt	ㅧ
bEts	ㅨ
bI	】
bIG	㕥
bIJ	㠙
bIb	㕗
bIbz	㕘
bId	㕙
bIg	㕠
bIl	㕣
bIld	㝩
bIldz	㝲
bIlt	㝳
bIlz	㕤
bIn	㔆
bInt	〣
bInz	慉
bIt	㕵
bIts	㕸
bIz	㠃
bO	㘩
bOG	㘰
bOl	㘧
bOld	㘨
bOz	㚆
bR	㐲
bRT	㕳
bRd	㕰
bRdz	㕱
bRk	㞓
bRn	㞔
bRnd	㞕
bRnt	㞖
bRp	㞗
bRps	㞙
bRpt	㞘
bRt	㕆
bRts	㕇
bRz	䉑
bU	㙃
bUS	㠁
bUSt	㠂
bUk	㙅
bUks	㙇
bUl	㝴
bW	㙱
bWd	㙸
bWl	㙹
bWlz	㚀
bWn	㙵
bWndz	㙷
bWns	㙳
bWnst	㙴
bWnt	㙶
bWt	〕
bY	ㅉ
bYk	㕡
bYks	㕢
bYn	䂇
bYt	㕶
bYts	㕷
bYz	㠖
b^	㈶
b^G	㞈
b^b	㝖
b^d	㝤
b^dz	㝥
b^g	㝦
b^gd	㝨
b^gz	㝧
b^ks	㝣
b^lb	吵
b^lbz	吶
b^m	㝶
b^md	㝷
b^mp	㞀
b^mps	㞃
b^mpt	㞁
b^mz	㞄
b^n	㞅
b^nC	㞆
b^nz	㞑
b^s	㠀
b^st	㠄
b^sts	㠇
b^t	㠈
b^ts	㠉
b^v	〖
b^z	㠗
ba	㍤
baG	㘶
baGk	㘸
baGkt	㘹
bab	㘤
babz	熉
bad	划
bak	㍦
baks	㚅
band	㘱
bap	㙠
baps	㙡
bar	㍧
barb	㐳
bark	㐸
barks	㑀
barkt	㐹
barn	㑁
bart	㑐
barz	㍨
baz	㍩
bc	㐈
bcg	㘦
bcl	㐄
bcld	㐃
bclz	㐅
bcrd	㤆
bcrn	㙣
bcrnz	嚈
bct	㙲
be	㍴
beb	㍲
bebz	㍳
bek	㎘
beks	㐁
bekt	㎙
ber	㐵
berz	㒈
bes	㑑
bi	〃
biC	㑷
bid	㑸
bidz	㑹
bif	㔅
bik	㒀
bil	㍐
bin	㒁
binz	㒂
bip	㔇
bips	㔉
bir	㔐
bird	㒇
bis	㒐
bist	㒉
bit	㒒
bits	㔒
biz	㍵
bl@G	㖅
bl@Gk	㖄
bl@k	㕹
bl@st	㖈
blE	㖗
blEnd	㖔
blEndz	㖕
blEs	㖖
blI	㝠
blIG	㍱
blIGk	㘄
blWs	㘒
blYnd	㘂
blYndz	㘃
bl^	㘘
bl^S	㘗
bl^d	㘉
bl^ks	啱
bla	㖂
blak	㘅
blaks	㘆
blakt	㘇
bland	㘈
blck	朠
bled	㖀
bledz	㖁
blem	㖃
bli	㖑
bliC	㖉
bliCt	㖐
blid	㖓
blo	㘓
bloz	㘔
blu	㘁
blum	㘐
bluz	㘖
blxmz	妔
bo	㘙
boT	㙧
bol	㚁
bolz	㚂
bon	㘲
bonz	㘵
bor	㘡
bord	㘠
bordz	捶
bot	㘢
bots	㘣
boz	㚃
br@n	㚔
br@nC	㚕
br@nd	㚖
br@s	㚗
br@t	㚘
brE	吥
brET	㜆
brEd	㜀
brEk	㜂
brEn	㜐
brEst	㜅
brI	㜗
brIG	㜤
brIGz	㜥
brIJ	㜖
brIk	㜔
brIks	㜕
brIt	㜰
brU	㜹
brUk	㜸
brW	㝆
brWn	㒆
brWnz	㝇
brWz	㝈
brY	㜓
brYt	㜠
br^	㝄
br^S	㝓
br^St	㝔
br^nC	㝒
bra	㚈
brc	㜲
brcT	㝃
brcd	㜱
brct	㝅
bre	㚒
bred	㚑
brek	㜁
breks	㜄
bren	㚓
bres	㚉
bret	㢅
brets	㢆
brev	㚙
bri	㜈
briD	㜇
brif	㜙
briz	㜉
bro	㜵
brok	㜴
brum	㝁
brumz	㝂
brus	㝉
bruz	㝐
bruzd	㝑
brx	䌕
brxz	爙
bu	〤
buS	㙔
bum	㙈
bumz	㙐
bun	㍶
bunz	㙁
bup	㙒
bups	㙓
bus	㙗
bust	㙖
but	㙘
buts	㙙
buz	㙂
bwEb	䁥
bx	㍥
bxT	䕧
bxf	爑
bxl	〓
bxld	匔
bxlz	㝙
bxn	愱
bxnd	刄
bxndz	刅
bxnz	愲
byu	〦
byus	〥
byx	䙔
c	ㅶ
cf	圩
cfs	夁
cg	㍄
cl	ㅔ
clz	坲
cr	䅇
crd	坖
ct	坦
d@	䉶
d@G	䊕
d@b	䉴
d@d	䉵
d@dz	䉷
d@l	䊆
d@m	䊐
d@mp	䊑
d@n	䊒
d@nd	儑
d@ns	䊔
d@nz	䊓
d@t	䌂
d@z	䉸
dE	䌔
dEd	䌑
dEk	䌠
dEl	䌲
dEn	〶
dEns	䌶
dEnt	〷
dEnts	〸
dEsk	䍈
dI	㊓
dIG	ぷ
dIGz	㝱
dIS	䐀
dId	ふ
dIg	䍹
dIgz	䎀
dIk	ぶ
dIl	䊀
dIlz	䊁
dIm	䎂
dIn	ㄶ
dInt	〵
dIp	䎅
dIps	䎆
dIs	䍉
dIsk	䎒
dIsks	䎔
dIst	偔
dIt	䈓
dIts	䈔
dIz	䐆
dR	ㅅ
dRd	㎈
dRt	䎇
dRts	䎈
dRz	ㅆ
dU	䔙
dW	䑒
dWn	䑑
dWnz	偆
dWt	䑈
dY	䍤
dYd	䍨
dYl	䈦
dYlz	䈧
dYv	䐖
dYvd	䐗
dYvz	䐘
dYz	䍩
d^	㐙
d^b	䔆
d^g	䔑
d^k	䔇
d^ks	䔉
d^lt	よ
d^lts	ら
d^m	䔓
d^mp	䔔
d^mpt	䔕
d^n	ㅕ
d^p	儸
d^s	䔡
d^st	䔠
d^v	䑐
d^z	䐢
da	䉳
daG	䐸
daJ	䐡
dag	具
dak	䐠
dal	䐩
dalz	䐨
dan	䐴
dar	䌀
dark	䊙
darn	䌁
dat	䑇
dc	䌄
dcG	䐹
dcg	䐤
dcgz	䐥
dcl	㍹
dclz	㎀
dcn	䌇
dcnz	䌈
dcr	㎃
dcrz	坰
dcs	䑆
de	㕴
dek	偷
del	䊅
dem	䊉
den	䊂
der	䊘
det	䌃
dez	䌉
dfIS	䤲
di	々
did	䉹
dil	䌒
dinz	ㄷ
dip	䌤
dir	䌓
diz	㈂
dli	䠱
do	ゅ
dom	䐲
dont	䐵
dor	ょ
dorm	䑅
dorz	䑂
doz	㍔
dpOnt	昦
dr@	䑘
dr@Gk	䑧
dr@g	䑖
dr@gd	䑗
dr@gz	䑢
drE	䒀
drEd	䑳
drEnCt	䑷
drEs	䑸
drEst	䑹
drI	䒈
drIG	䒆
drIGk	䒄
drIGks	䒅
drId	冖
drIdz	冗
drIl	䒃
drIn	㥕
drInt	刈
drIp	䒇
drIps	䒉
drWn	䒘
drY	䒑
drYd	䒂
drYr	䔄
drYv	䒐
drYvz	䒒
drYz	䔅
dr^	䔁
dr^G	䔃
dr^Gk	䔂
dr^m	䒙
dr^mz	䔀
dra	䑥
drap	䒔
draps	䒖
drapt	䒕
drc	䑩
drcr	䑰
drcrz	䑱
drcs	瀄
drcz	䑲
dre	䌰
dren	䑣
drep	䑨
dri	㆙
drim	䑴
drimd	䑵
drimz	䑶
drol	慑
drom	杘
drov	䒗
dru	䒁
drul	䒓
drum	㔃
druz	㈁
drx	䑦
du	䁨
dud	䔐
duks	䔒
dup	䑁
dus	妕
dust	剒
dwIC	戃
dwcks	捙
dx	㜑
dxd	㝰
dxkt	妖
dxkts	妗
dxl	㞇
dxld	偅
dxlz	㡁
dxm	び
dxmz	ぴ
dxn	䔹
dxns	䅣
dxnt	䅱
dxnz	䡩
dxs	䘨
dxst	䤸
dxv	捃
dxz	㜒
dyx	䔣
e	、
eC	倣
eD	㌳
eJ	ㄆ
ed	ㄠ
edz	ㄡ
em	ㄢ
emd	ㄣ
en	㆖
ent	ㄤ
er	ㄥ
et	㉨
etT	䕐
ets	㉩
f@	䙓
f@k	と
f@kt	䙠
f@m	䙳
f@n	䙴
f@nz	䙵
f@st	䚁
f@t	䚃
fE	䙣
fEC	䜅
fEd	䚑
fEf	䜆
fEk	䐃
fEkt	塓
fEl	䜀
fElt	䜁
fEn	䌦
fEns	䜂
fEnst	䜃
fI	㢗
fIG	㢙
fIS	䜲
fIf	䜇
fIfT	䜉
fIg	䜑
fIgz	䜓
fIk	䝂
fIks	䝁
fIkst	䝃
fIkt	塔
fIl	䜘
fIld	䜙
fIlm	䜠
fIn	䐰
fInt	䕠
fInts	䕡
fInz	䐱
fIs	圲
fIst	䜴
fIsts	䜵
fIt	䜶
fIts	䜷
fR	㦇
fRd	䀡
fRdz	䀢
fRm	䜰
fRst	䜱
fRt	䂐
fRz	圱
fU	㐷
fUl	䡐
fUlz	䉕
fUt	㐶
fUts	䞒
fWl	䠇
fWn	䠉
fWnd	䠈
fY	䚙
fYd	䤕
fYn	䜢
fYnd	䜡
fYndz	䜣
fYr	䜨
fYrz	䜩
fYt	䜒
fYv	䝀
fYvz	儖
f^	䡔
f^G	唥
f^Gk	䡓
f^m	䡑
f^n	䡒
f^s	䡖
f^st	䡘
f^z	䡡
fa	䑄
far	䙶
farf	㊅
farm	䙷
fart	䚀
farz	創
fc	䙩
fck	䠓
fcks	䠒
fcl	䙨
fcls	䙱
fclt	䚅
fclz	䙰
fcn	䚈
fcr	䞓
fcrk	䠀
fcrks	䠁
fcrm	刲
fcrmd	䠂
fcrmz	刳
fcrn	㠨
fe	䙙
feT	䙤
fed	䙡
fek	䙥
feks	䙧
fekt	䙦
fer	䙢
fes	䙖
fest	䙘
fets	䚄
fi	㕲
fid	䚒
fidz	䚓
fil	䚔
fild	䅘
filz	䚕
fir	䚉
fist	䚐
fit	䚗
fits	䚘
fiz	䚖
fl@	䝒
fl@S	䝑
fl@g	䝄
fl@p	䝉
fl@ps	䝐
fl@t	䝔
flEk	悔
flEr	䝅
flErz	䝆
flI	䝣
flIk	刱
flIkt	䝙
flIp	䝠
flIps	㎅
flR	䝤
flW	㡸
flWnt	䝱
flY	䑡
flYr	䝹
flYz	㠐
fl^	䝶
fl^S	䝸
fl^f	䝵
fla	䝰
flap	䝡
flaps	䝢
fle	䝕
fleks	䝇
flit	䝗
fliz	䝖
flo	䝦
flor	䝨
florz	䝩
flot	䝥
flots	䝧
floz	䝴
flu	䝘
flx	䝈
fo	䞂
foks	䞆
fol	䞅
fold	䞄
fom	䞁
fon	喅
fonz	䔩
for	㔓
forT	䠅
forTs	䠑
ford	ゖ
forst	䞔
forz	䠐
fr@G	䠖
fr@Gk	䠕
fr@k	悕
frE	䠠
frES	䠣
frEd	䠙
frEn	䠰
frEnC	䠢
frEnd	䠨
frEndz	䠩
frI	゘
frIJ	䠦
frIk	䠤
frIl	䠳
frIns	䍲
frInt	䍴
frIz	䠴
frWn	䡃
frY	䠥
frYd	䠧
frYz	䠲
fr^	䡇
fr^m	䠸
fr^nt	䠹
fr^nts	䡀
frag	㝵
frc	䠷
frcg	䠵
frcgz	䠶
frcs	䡂
frcst	䌧
fre	ㅇ
fred	゗
frem	䠔
frez	塥
fri	䠘
frik	䠗
friz	䠡
fro	䡅
froz	䡄
fru	䡉
frut	䡁
fruts	䡆
frx	刴
frxns	悓
frxnt	䍶
fu	䕆
fud	䞈
fudz	䞉
ful	䞐
fuld	䞑
fx	ㅦ
fxl	㍙
fxlz	㍠
fxn	到
fxnt	利
fxnts	䕢
fxst	㜃
fxt	噈
fyU	䡕
fyu	䄒
fyuJ	悖
fyum	塕
fyuz	䄐
fyuzd	䄑
g@	䡢
g@n	㔕
g@p	䡦
g@s	䡲
g@spt	䡳
g@t	䡵
gE	ㅴ
gEn	㄄
gEnst	ㄅ
gEs	倈
gEst	倉
gEsts	倐
gEt	䞕
gEts	䞖
gI	㔙
gIG	㔗
gIGz	吘
gIJ	咙
gIfs	䢖
gIft	䢕
gIl	倒
gIn	㔘
gInz	㔠
gIst	呴
gIt	䤈
gIts	圐
gIv	䞗
gIvz	䤉
gR	㔖
gRl	䤆
gRlz	䤇
gRt	熕
gRts	熖
gRz	㙄
gU	䤷
gUd	䤶
gWn	䥇
gWnz	䥈
gY	候
gYd	們
gYz	倠
gYzd	䎗
g^	䎙
g^lz	扒
g^m	倔
g^mp	倕
g^mz	倖
g^n	㔡
g^nz	倗
g^s	倘
g^st	䎘
ga	䞙
gaS	䥅
gad	䤨
gadz	䤩
gan	圥
gar	䡨
gard	倆
gardz	倇
gat	䞘
gats	䥆
gc	㡶
gclf	䤴
gcn	䐦
gcr	䥃
ge	ㅘ
gel	〒
gelz	䡣
gem	㐇
gemz	䡥
gend	䡤
get	䡶
gets	䡷
gev	䡹
gi	ㄇ
gir	䢀
girz	䢁
gis	䢂
giz	㎖
gl@	䙐
gl@d	䤐
gl@s	䤑
glEk	嚁
glEts	塱
glIG	杴
glIS	䖄
glIts	塲
gl^b	䤡
gl^mp	䤣
gl^v	䤙
gl^vz	䤠
glc	䤘
glcs	䤗
gli	撑
glo	䤔
glob	䤒
glu	䤓
glud	䤢
go	ㄓ
gol	䤥
gold	䤱
gost	䢒
got	䤦
gots	䤧
goz	㘷
gr@	䄔
gr@b	䥉
gr@bd	䥐
gr@bz	䥑
gr@f	㍇
gr@m	䥗
gr@mps	䥘
gr@mz	䥙
gr@n	䥡
gr@nd	䥠
gr@nt	䥥
gr@s	䥩
gr@sp	䥨
gr@t	慷
gr@ts	慸
grE	ㄉ
grEg	䥷
grI	䦀
grIl	䦁
grIld	䦂
grIn	䦃
grInC	䦄
grIp	䦇
grIt	䦈
grIts	䦉
grW	䦓
grWC	䦒
grWl	䦗
grWld	䦘
grWnd	㎆
grYn	䦆
grYnd	䦅
gr^f	唇
gr^m	倂
gr^n	倃
gr^nt	倄
gr^nts	倅
gre	䥓
gred	䥔
gren	䥖
grep	䥦
greps	䥧
gres	䥒
gret	䥰
grets	䥴
gri	ㄔ
grid	ㄕ
grif	䥹
grik	䥵
grin	䥶
gris	䥳
griz	䌨
gro	䦐
groT	倁
gron	䦙
gros	䦑
gru	䥸
grup	䦕
grx	ㄈ
gu	䢗
guf	䥀
gus	䥂
gwI	䙅
gwIJ	历
gwIn	塈
gwa	刕
gx	㐔
gxl	㈇
gxld	撐
gxlz	䢘
gxn	䑙
gxnt	䕙
gxnz	䑠
gxs	㌠
gxst	㍆
gxz	匥
gyR	䜔
gyu	㊆
gyx	㊉
h@	値
h@CllG	偢
h@G	偃
h@Gz	偉
h@S	偙
h@Ul	㊖
h@b	ㄖ
h@d	倥
h@f	倦
h@fs	倵
h@g	倧
h@m	倷
h@n	偁
h@nd	倹
h@ndz	偀
h@ps	塖
h@t	偡
h@ts	健
h@v	偦
h@z	偘
hE	倱
hEJ	傑
hEd	ㄗ
hEdz	偸
hEl	傁
hElT	傀
hEld	傓
hElp	傖
hElps	傘
hElpt	傗
hEn	備
hEnz	儀
hEr	倲
hErz	偕
hI	儂
hId	儉
hIl	儙
hIlz	儠
hIm	儡
hInJ	儢
hInt	儣
hIp	儤
hIps	儥
hIt	儨
hIts	儩
hIz	儧
hR	儁
hRd	傅
hRt	刁
hRts	刂
hRz	儃
hU	兕
hUd	兒
hUk	兓
hUks	兖
hUkt	兔
hW	㈷
hWd	冃
hWnd	兹
hWs	䐧
hWz	冁
hY	䌩
hYd	儐
hYk	儘
hYnd	㔥
hYr	儕
hYrd	儦
hYt	䢑
h^	兆
h^G	冘
h^S	分
h^f	冇
h^ft	冈
h^g	冉
h^gd	冑
h^gz	冒
h^m	冓
h^mp	冔
h^n	冕
h^nt	刀
h^t	切
h^z	刃
ha	ㄘ
haG	光
hab	恡
hag	儴
hagz	傒
hak	兀
han	夠
hap	兠
haps	兦
hapt	兤
har	㜶
hard	偓
harm	偖
hart	傇
harts	傈
has	关
hat	其
hats	典
hc	儳
hcG	児
hcGk	先
hcg	䦔
hck	偨
hcl	ㄹ
hcn	偩
hcr	兩
hcrn	全
hcrnz	兰
hcrs	共
he	㔣
heG	偈
her	倨
herd	倰
herz	倩
het	偣
hets	偤
hevd	㔢
hi	偳
hid	側
hil	偵
hilz	偹
hip	傂
hipt	傃
hir	傄
hirz	傆
hit	傉
hiz	偶
ho	儲
hoI	ㄙ
hol	㠔
hold	儶
holdz	儷
holz	儹
hom	兂
homz	兄
hop	兡
hops	兣
hopt	兢
hosts	兵
hoz	兲
hu	兑
hum	焅
hup	兗
hups	兘
hut	兙
huz	焃
hx	倳
hxm	儰
hyu	円
hyuJ	冐
i	〆
iC	䔤
il	䕄
in	䕅
ir	䔥
irz	䔱
it	䔶
its	䔷
iv	䘇
iz	㑵
ja	垔
ju	楷
k@	㠘
k@C	㡵
k@G	匤
k@f	㠧
k@k	㠢
k@l	㠥
k@m	㠶
k@mp	㠵
k@mps	㠸
k@mpt	㠷
k@n	㠹
k@nd	瀰
k@nt	㡀
k@nz	㡄
k@p	㡆
k@pt	偂
k@sts	㡨
k@t	㡩
k@ts	㡰
kE	㡠
kEl	匳
kEn	匴
kEnd	灧
kEpt	匵
kEr	䌐
kEt	慒
kI	㖆
kIG	㍀
kIGz	卑
kIJ	垂
kId	卂
kIdz	千
kIk	匹
kIks	十
kIkt	區
kIl	卄
kIld	卅
kIlz	卆
kIm	升
kIn	㥉
kInz	㥐
kIs	卒
kIst	卓
kIt	㑗
kIts	㖇
kOGk	圷
kOnz	䁱
kR	ざ
kRb	䉗
kRd	圣
kRdz	䉘
kRl	䉠
kRld	䉡
kRs	䉢
kRz	㐀
kU	䅁
kUd	䅰
kUk	䄹
kUks	䅂
kUkt	䅀
kW	䅨
kWC	䅧
kWn	䅲
kWnt	ぁ
kWnts	䅷
kWt	㤨
kWz	䆅
kY	㥆
kYl	即
kYlz	却
kYn	卉
kYnd	午
kYndz	卐
kYt	協
k^	ぃ
k^G	危
k^b	䉈
k^d	䉒
k^l	䍸
k^m	㒘
k^mz	㒙
k^n	䅴
k^p	䉔
k^ps	䉖
k^s	䎕
k^st	䞃
k^t	䉥
ka	㍓
kab	䁤
kak	䁧
kam	䂆
kan	䂙
kap	傔
kaps	䅐
kar	㡈
kard	㡑
kardz	㡔
karl	㡗
kart	㡤
karts	㡧
karz	㡉
kat	㉳
kats	㉴
kc	㠱
kcf	䅩
kcl	㠩
kcld	㠰
kclm	㠳
kclz	㠲
kcr	〹
kcrd	䅑
kcrdz	䅒
kcrk	䅕
kcrkt	䅖
kcrn	䅗
kcst	䅤
kcsts	䅥
kct	㡷
kcz	㒗
ke	㠡
keJ	㠤
keZ	圢
kek	㍷
keks	㍸
kem	㒖
ken	㡂
kep	䘁
ker	㡕
kerz	㡖
kes	㙆
ket	䂒
kev	㢁
kevz	㢂
kez	匰
ki	㎇
kip	匱
kips	匲
kiz	㕦
kl	晓
kl@	䀄
kl@mp	䀂
kl@p	䀃
kl@s	䀅
klE	䀘
klErd	䌢
klErz	䌣
klI	䀠
klIG	㝢
klIGk	䀩
klIGz	䔈
klIk	䀙
klIn	㝀
klIp	䀰
klIps	䀳
klIpt	䀱
klIr	䀗
klR	文
klW	䁆
klWd	䁅
klWdz	䁇
klWn	䁈
klWnz	䁉
klWs	䀆
klY	䀥
klYm	䀣
klYmd	䀤
klYmz	䀦
kl^	䁙
kl^G	䁘
kl^Gk	䁗
kl^b	䁐
kl^k	䁑
kl^m	䁕
kl^mps	䁔
kla	圔
klaT	䙗
klak	䀶
klaks	圕
klap	䀷
klc	䀵
klcT	䁃
klcTs	灇
kle	䀇
kler	䌡
kli	㍉
klin	䀈
klind	䀉
klinz	䀒
klir	䀔
klird	䀕
klo	䁀
kloDz	䁄
kloks	䀴
klos	䀸
klozd	䀹
klu	䁒
kluz	䁓
klx	悒
ko	㥑
kod	䁰
kok	䁲
kol	䁶
kold	䁴
koldz	䁵
kolts	䂁
kom	䂄
komd	䂅
komz	䂈
kon	䄉
konz	墂
kor	䆁
kors	䆀
kos	䁠
kot	䁢
kots	䁣
koz	唹
kr@	䆉
kr@G	䆗
kr@Gk	䆖
kr@S	䈀
kr@St	䈁
kr@b	䆈
kr@k	䆐
kr@kt	䆑
kr@mpt	䆓
kr@n	䆔
kr@p	䆙
krE	䈒
krI	㦄
krIG	䈠
krIb	䈘
krIp	奶
krIs	㦂
krIt	扣
krIts	扤
krU	䈨
krUks	䈰
krW	䈴
krWd	䈳
krWn	䈶
krY	䉆
krYd	䈙
krYst	㦃
kr^S	䉃
kr^d	䈷
kr^m	䈹
kr^mz	䉀
kr^n	䉂
kr^nC	䉁
kr^s	䉅
kr^st	䉄
kra	䈥
krak	䈤
kras	䈲
krc	䈄
krcl	䈂
krcld	䈃
krclz	䈅
krcs	し
krcst	䈱
kre	䆒
kren	䆕
krezd	䈈
kri	䈐
krik	䈕
krim	䈉
krip	䈖
kris	刧
kro	䈣
krod	䈵
kru	䈗
krum	煅
kruz	䈸
krx	善
kt	攳
ku	䅅
kul	䅃
kuld	䅄
kun	䁩
kunz	恕
kup	䅆
kut	䉨
kw@	怴
kw@k	怳
kwE	㉷
kwEn	扸
kwEs	恄
kwI	ご
kwId	呓
kwIdz	呔
kwIk	恅
kwIlt	恇
kwIlts	恈
kwIn	恉
kwIp	䖙
kwIt	恐
kwIz	恒
kwIzd	恓
kwRd	㍡
kwRdz	㎑
kwY	恆
kwYrz	愐
kwYt	恑
kwa	怷
kwaS	㎒
kwan	卲
kwc	怸
kwcr	怹
kwek	䔳
kwel	怵
kwelz	怶
kwi	恀
kwik	恁
kwin	恂
kwot	恔
kx	゙
kxb	剳
kxbz	剴
kxd	䈩
kxg	悐
kxl	㈒
kxld	㝡
kxlt	䍷
kxlz	㈓
kxm	㦖
kxn	㄀
kxnd	扡
kxndz	扢
kxp	儇
kxps	儈
kxs	㦘
kxt	䡗
kxz	梉
kyU	䉙
kyUr	扥
kyard	㎓
kyu	㐰
kyub	䉉
kyubz	䉐
kyud	愑
kyum	榕
kyumd	榖
kyumz	榗
kyus	䘣
kyut	䉦
kyuz	愒
kyuzd	あ
kyx	㕧
l@	ㄴ
l@C	厑
l@G	厅
l@f	厒
l@fs	厔
l@ft	厓
l@k	卷
l@ks	愂
l@kst	愃
l@m	卸
l@mp	厁
l@mz	卹
l@n	厃
l@nd	厂
l@p	厈
l@ps	䁷
l@s	䙉
l@st	厐
lE	䕣
lEJ	吓
lEd	吒
lEf	吕
lEft	吔
lEg	吖
lEgz	吙
lEk	䁹
lEkt	䁸
lEktrp	䕕
lEs	㥳
lEt	吢
lEts	吣
lI	ㅗ
lIG	㐉
lIGks	呈
lIGz	㢃
lIJ	げ
lIJd	こ
lIS	失
lISt	夲
lId	吧
lIdz	吨
lIf	吳
lIft	吲
lIfts	吴
lIg	ㅃ
lIk	䡱
lIks	ㅀ
lIkt	否
lIl	呀
lImz	呂
lIn	ㅖ
lInJ	㤈
lInd	呅
lIns	捤
lInt	䘙
lIp	呑
lIps	呒
lIs	ㅐ
lIst	呕
lIsts	呗
lIt	㚐
lIv	员
lIvd	呙
lIvz	呠
lIz	呡
lR	㝘
lRd	䂀
lRdz	䎁
lRn	吇
lRnd	合
lRnz	吉
lRz	㕨
lU	呶
lUk	呵
lUks	呸
lUkt	呷
lUr	唄
lW	ㅠ
lWd	ㅡ
lY	ㅢ
lYd	吩
lYf	吱
lYk	ㅒ
lYks	吹
lYkt	吸
lYm	呃
lYn	ㄧ
lYnd	呆
lYt	䝓
lYts	䕖
lYv	ㅓ
lYz	吰
lYzd	䀁
l^	咕
l^k	咘
l^ks	䌳
l^m	唁
l^mp	唀
l^mz	䂃
l^n	呲
l^nC	唂
l^v	咓
l^vd	咔
l^vz	咖
la	䁳
lab	呧
lak	周
laks	䤳
lakt	呩
lan	厘
lap	咅
larJ	厉
larm	ㄸ
lat	咑
lats	咒
lc	厗
lcG	ㅥ
lcGd	味
lcGz	㔵
lcg	㡲
lcgz	㡱
lcn	厕
lcr	咈
lcrd	咆
lcrdz	咇
lcst	咐
le	㐆
led	吀
lek	ㅁ
lem	厀
len	厄
les	卵
lest	卶
let	䄕
lez	吁
li	〠
liS	吐
lif	㔩
lin	吂
lind	吃
lip	各
lips	吆
lipt	吅
lis	䕦
list	向
lit	䌱
liv	㔰
livd	㔱
livz	㔲
liz	㌒
lo	㊔
lod	㔴
lodz	呣
lof	呤
lon	ㅤ
lonz	呥
lop	㡅
lops	䖗
lovz	呦
loz	䞇
lri	㢀
lrod	恣
lu	㐓
lum	呹
lun	㐐
lunz	㐑
lup	咀
lups	咂
lupt	咁
lus	咃
lust	咄
lut	〙
luz	咉
lwInd	炙
lwez	ㅷ
lx	ㅈ
lxdz	憕
lxk	䕔
lxm	䂂
lxn	㐤
lxnd	䡰
lxndz	剣
lxns	ㆆ
lxnz	㥧
lxs	䙕
lxts	抙
lxz	㦕
lyIn	喖
lyInt	㜣
lyR	䙲
m@	㍈
m@C	啒
m@G	唴
m@S	啈
m@St	啉
m@T	啕
m@d	唐
m@g	唑
m@gz	唕
m@k	ど
m@ks	啘
m@l	唤
m@m	唆
m@n	㑲
m@nd	䌴
m@p	唶
m@s	啐
m@t	厖
mE	ㆉ
mES	啷
mEZ	啨
mEg	啰
mEks	㐒
mEl	啳
mElt	啲
mElts	啴
mEm	啵
mEn	ㆈ
mEnt	㢉
mEnts	噂
mEr	嚕
mEs	䐳
mEst	啹
mEt	喀
mEts	喂
mI	䂉
mIC	戀
mIG	㔀
mIJ	䊇
mId	喇
mIk	䤁
mIks	䤂
mIkst	嘇
mIl	喕
mIlk	喔
mIn	㕄
mInd	䍗
mInt	ㆁ
mInts	剅
mInz	瀗
mIs	嘂
mIst	嘃
mIt	傕
mIts	呄
mIz	噅
mO	嘐
mR	㝸
mRd	捦
mRz	䙸
mW	嘶
mWT	嘷
mWTs	嘹
mWn	嘴
mWnt	㆒
mWs	嘵
mY	劒
mYk	喐
mYks	喑
mYl	喒
mYlz	喓
mYn	喙
mYnd	喘
mYndz	愅
mYs	喃
mYt	喉
m^	䤰
m^C	噆
m^G	㆑
m^Gks	㥤
m^S	噖
m^St	噗
m^d	噇
m^g	噉
m^gz	噐
m^k	啡
m^l	噑
m^m	噓
m^n	嘓
m^nC	噔
m^nT	嘗
m^nTs	嘘
m^s	噣
m^st	噡
ma	㈑
mal	唰
malt	唩
mam	嘑
mamz	嘒
man	嘕
mans	嘖
manst	嘔
map	嘦
maps	嘩
mapt	嘧
mar	唷
marC	唸
marS	啅
mark	啁
marks	啃
markt	啂
marz	啄
maz	䥢
mc	啗
mcDz	嘳
mcl	唨
mcr	㐕
mcs	嘱
me	ㆂ
med	元
medz	唖
mek	唡
meks	唣
mekt	唢
mel	䕳
meld	唗
melz	唘
men	唙
met	啓
mets	啔
mez	ㆀ
mezd	ㅹ
mi	ㆇ
mil	啢
min	啣
mind	啤
minz	啥
mit	唃
mits	啩
miz	㝹
mo	䕩
mod	嘉
mon	桰
mor	㈸
mos	嘲
most	ㅣ
mot	䕷
moz	䕰
mu	唲
muS	嘢
mud	嘙
mun	嘠
mus	嘡
muv	噀
muvd	噁
muvz	噃
mw^n	攆
mwat	攉
mwer	攐
mx	㊒
mxJd	䊈
mxk	倸
mxl	㈉
mxlz	㈐
mxm	啙
mxn	㡘
mxnd	䍥
mxndz	䍦
mxnt	䖘
mxnts	や
mxnz	吠
mxs	䖉
mxz	唱
my^m	爓
my^mz	爔
myu	㆔
myulz	噒
myuzd	㆓
myx	䠃
n@	㐗
n@C	噳
n@U	圆
n@k	卖
n@n	噧
n@nz	器
n@p	南
n@ps	噩
n@s	噱
n@t	䤤
nE	䍧
nEd	噸
nEk	䄗
nEks	刨
nEkst	嚑
nEkt	䄖
nEl	塙
nEs	䆘
nEst	嚅
nEsts	嚆
nEt	則
nI	㈈
nIC	敔
nIG	㍖
nIJ	䑤
nIJd	唳
nIS	䅙
nISt	䜧
nIT	恥
nIg	圀
nIk	䀧
nIks	䀨
nIkt	垗
nIn	呇
nIns	唠
nInt	奱
nIp	唵
nIs	ㄒ
nIst	䀑
nIt	㙀
nIts	㠠
nO	㈘
nOd	堂
nOz	嚙
nR	㐠
nRs	圓
nRv	嚂
nRvz	嚃
nRz	䀐
nU	圁
nW	圉
nY	䌸
nYf	占
nYfs	卡
nYn	嚗
nYnT	嚘
nYs	嚒
nYt	䤹
nYts	嚔
nYz	块
nYzd	坘
n^	㈣
n^f	䖐
n^m	園
n^n	写
n^p	䀓
n^ps	倀
n^t	㠒
n^ts	䑉
na	け
nab	卢
nabz	卣
nak	卤
naks	卦
nakt	卥
nat	㡃
naz	噰
nc	噴
ncl	楨
ncr	䖈
ncrT	圄
ne	㡐
nel	䜤
nelz	䜥
nem	噤
nemd	噦
nemz	噥
net	䅈
nez	啠
ni	㈔
niT	㕂
nid	噹
nidz	嚀
nik	楹
nil	卙
nin	㘥
ninz	㘳
nir	噵
nis	嚓
nit	噶
niz	㈕
no	㘴
non	卧
nop	圂
nops	圃
nor	刔
not	圇
nots	䄙
noz	卨
nozd	圅
nu	㍑
nud	愆
nun	㄂
nut	嘀
nuz	嚐
nx	㈠
nxl	㡒
nxld	䐶
nxldz	䐷
nxlz	㡓
nxm	墙
nxt	䑀
nxz	㈰
nyIn	坉
nyIns	䄸
nyR	匡
nyu	䄰
nyxn	坃
nyxs	䢅
o	㥂
ol	址
old	圹
olz	坙
on	坅
ond	坸
ot	圖
ots	圗
oz	㤷
p@	㌙
p@C	堗
p@Ct	堘
p@T	堙
p@d	呁
p@dz	垅
p@k	垁
p@ks	垄
p@kt	垃
p@l	垕
p@m	垖
p@n	㥠
p@nt	垙
p@nts	堀
p@nz	垘
p@s	堑
p@st	堒
p@t	堖
p@ts	堥
pE	䘴
pEG	塇
pEGg	塉
pEg	塅
pEgz	塆
pEkt	䘩
pEn	䍀
pEnd	䌹
pEndz	䍁
pEnz	塑
pEp	塒
pEr	女
pErd	䂓
pEs	塡
pEt	塢
pEts	塤
pI	㉕
pI9	墄
pICt	墐
pIG	㞂
pIGk	境
pIGz	䦖
pId	夷
pIg	塩
pIgz	塳
pIk	塦
pIks	塨
pIkt	塧
pIn	塷
pInC	塹
pInCt	墀
pInt	批
pInz	墅
pIp	墇
pIrz	塄
pIst	䌥
pIt	㡙
pIts	噕
pIz	夸
pO	夤
pOn	䎐
pOnt	㉥
pOnts	夣
pOz	夥
pR	㔈
pRd	吡
pRl	堷
pRs	塠
pRz	䀲
pSIs	扑
pU	契
pUS	怨
pUSt	怩
pUl	怖
pUld	怗
pUlz	怘
pUr	奀
pUt	刷
pUts	怱
pW	奕
pWC	奔
pWlz	奣
pWn	奘
pWnd	套
pWndz	奙
pWnt	奖
pWt	焧
pY	䉩
pYk	塴
pYl	塵
pYlz	塶
pYn	墁
pYp	墆
pYr	瀁
pYz	䍐
p^	怓
p^G	怤
p^b	怒
p^f	怔
p^ft	怕
p^m	怡
p^mp	怠
p^nC	怣
p^p	奃
p^ps	急
pa	㉈
pad	夢
pan	䅸
pand	夳
pans	愕
panz	䅹
pap	呰
paps	呱
papt	奁
par	㉆
park	堅
parkt	堆
part	㉅
parts	堐
pat	奐
pats	奒
paz	䥣
pc	堩
pcl	堧
pclz	堨
pcn	榆
pcr	则
pcz	堰
pczd	報
pe	㉉
peJ	垆
peJd	垇
ped	垈
pel	垉
pen	垐
pent	垑
per	垒
perz	垓
pes	堕
pest	堔
pet	堉
pev	堲
pi	㉒
piC	堶
pid	㢓
pik	堸
piks	堹
pil	塀
pild	塁
pilz	㉑
pin	塸
pip	塂
pipt	塃
pir	䎉
pird	㉔
pis	嘸
pit	塣
piz	儆
pkIn	怢
pl@	墓
pl@n	墒
pl@nt	墔
pl@nts	墕
pl@s	墖
plE	夅
plEZ	夈
plEn	㉇
plI	䂗
plIG	䔖
plW	夑
plY	㉣
plYd	㉡
plYz	㉢
pl^	榀
pl^g	夒
pl^gd	夓
pl^gz	夔
pl^m	夕
pl^mz	外
pl^nJd	夗
pl^s	夘
plak	爤
plap	変
plaps	夐
ple	䂔
pled	夀
plen	ㄨ
plenz	㄰
ples	䘒
plest	墑
plet	増
plets	墘
plez	夃
pli	䂖
plit	䂕
pliz	夆
plizd	备
plo	䔗
plor	䘸
plu	夙
plx	䘶
po	䆇
pok	夦
poks	夨
pokt	大
pol	天
polz	夰
por	奠
porC	奄
pord	奡
port	嚉
porz	奢
pos	奈
post	奆
posts	奉
poz	䐈
pozd	坐
pr@k	奤
prE	䙃
prEg	奰
prEs	䙁
prEst	刡
prEt	妁
prI	㉲
prIk	妅
prIkt	妆
prIn	妐
prIns	妉
prInts	䜦
prIs	奵
prIt	剈
prWd	怄
prWl	怇
prY	妇
prYm	妈
prYs	妄
prYv	䍂
prYvd	䍃
prYz	妒
prYzd	朤
pra	刢
prab	妓
pre	奥
prer	奨
prerz	奩
prez	奦
prezd	奧
pri	㉦
priz	㡇
pro	刣
proCt	㉰
prop	㉱
pru	怆
pruf	怀
prunz	怈
pruv	怅
prx	如
prxn	㉵
pti	䕹
pu	堁
pul	夵
pum	怙
pun	枘
pup	夶
pups	夹
puz	头
px	㙢
pxl	㉘
pxld	椵
pxlz	㉙
pxn	偐
pxnd	偑
pxnz	偒
pxs	圦
pxt	嘨
pyU	性
pyu	䂘
pyx	奂
r@	㞐
r@G	㙉
r@S	恶
r@f	䤄
r@fs	䤅
r@g	恙
r@gz	恠
r@l	䅠
r@m	恨
r@n	嘁
r@nC	恰
r@p	恱
r@ps	恲
r@pt	恳
r@s	恵
r@t	恸
r@ts	恹
r@z	恷
rE	ㅩ
rEd	悂
rEg	悘
rEk	㈡
rEks	愧
rEkt	䅡
rEm	愄
rEn	䍵
rEnt	堄
rEnts	愇
rEp	愉
rEr	恴
rEs	䔘
rEst	愖
rEt	㑄
rEts	㑅
rI	㆐
rIC	愵
rIG	ㄦ
rIGz	䔰
rIJ	㕕
rIS	䢔
rIbz	愳
rId	愷
rIf	挠
rIk	㤕
rImp	捔
rIn	䍳
rInJ	坓
rIns	㉓
rInst	慀
rInt	㉐
rInts	堃
rIp	慁
rIps	慄
rIpt	慃
rIs	䜄
rIst	䕵
rIt	㡡
rIts	㡢
rO	䅓
rOz	䅔
rR	䀖
rRz	䕸
rU	慠
rUf	慙
rUt	慣
rW	慩
rWn	朥
rWnd	㊙
rY	ㅱ
rYd	愸
rYdz	愹
rYm	愨
rYmz	愩
rYp	慂
rYs	愴
rYt	ㅰ
rYts	煖
rYvd	㌄
rYz	㊐
r^	慨
r^S	憅
r^St	憆
r^b	慲
r^bd	慳
r^bz	慴
r^f	慧
r^g	慶
r^gz	慹
r^m	憂
r^n	憃
r^nz	憄
r^pt	剉
ra	匧
raZ	䡧
rak	塘
raks	慓
ram	慗
ran	慘
rant	愗
rc	慈
rcG	煗
rcl	㥴
rcs	慥
re	㊃
red	䡸
rek	䔧
rel	恢
ren	㌂
renJ	㌀
renJd	㌁
rend	恤
renz	恦
res	恖
rest	恗
ret	㌢
rets	㌤
rez	恧
ri	㈗
riC	悀
riCt	悁
riT	煔
rid	㞒
ridz	悃
ril	剤
rin	杲
rinz	杳
rir	悄
ris	楰
riz	㑴
ro	㙥
rod	㙤
rodz	慅
rol	慔
rold	慕
rolz	慖
rom	劔
rop	慤
ror	慆
rost	慇
rot	慦
rov	慱
roz	億
ru	㊘
rud	慵
rul	憀
rulz	憁
rum	夂
rumz	噙
run	㑈
runz	㑉
rus	慢
ruz	匦
rx	ゆ
rxk	㤔
rxl	㑂
rxld	䜸
rxlz	㑃
rxm	䠆
rxn	㑇
rxnts	䥤
rxnz	匨
rxp	杙
rxs	䊖
rxz	㠴
s@	憔
s@G	戄
s@d	憇
s@k	単
s@l	憗
s@m	憘
s@n	戂
s@nd	戁
s@nt	墉
s@t	戅
sE	㢄
sEd	憉
sEg	扱
sEk	扠
sEks	抐
sEl	㢇
sElf	儅
sElt	扲
sElvz	栤
sElz	㢈
sEm	㌥
sEn	㢑
sEnd	扳
sEndz	扴
sEns	扵
sEnt	㢐
sEnts	㢔
sEp	〰
sEpt	〩
sEs	䘠
sEst	圡
sEt	抃
sEz	成
sI	〴
sIG	㖙
sIGk	捧
sIGz	㘀
sIJ	啸
sIZ	䌘
sIb	捗
sId	㖘
sIf	匈
sIg	捡
sIk	㈢
sIks	㑓
sIl	捥
sIm	䉰
sIn	㦓
sInd	㦅
sIns	圑
sInt	䌖
sInz	䚂
sIp	捨
sIps	捰
sIpt	捩
sIs	㌦
sIst	券
sIsts	剀
sIt	㎁
sIts	捱
sIv	ㄐ
sIz	〧
sOld	攁
sR	㈥
sRC	扖
sRCt	扗
sRd	㈦
sRnd	䄃
sRnz	䄄
sRt	䄅
sRts	䄆
sRv	技
sRvd	抁
sRvz	抂
sRz	㈧
sUr	枀
sW	攦
sWT	攨
sWn	攢
sWnd	攡
sWndz	攣
sY	䌗
sYd	㕉
sYdz	㕐
sYn	捠
sYnd	换
sYnz	捣
sYt	䘡
sYz	䘥
sYzd	捳
s^	兇
s^C	朐
s^b	朅
s^d	朕
s^dz	朔
s^k	朑
s^ks	朓
s^kt	朒
s^l	朙
s^m	攅
s^n	攑
s^nz	攕
s^p	朢
sa	撕
saI	楸
saZ	啑
sak	撖
saks	撗
sam	怉
samz	怐
sapt	攘
sc	䘦
scG	攒
scGz	攔
scf	撙
scft	撘
scl	唅
sclt	憖
sclts	攇
scr	䎃
scrt	㌩
scrts	攠
scrz	䎄
scs	㉗
se	䄇
sef	憈
sek	䠄
seks	憓
sel	憐
seld	憑
sem	憙
sent	憒
sev	戇
sevd	戈
sevz	戉
sfYz	戆
sfxl	有
shEd	梔
sh^	捐
si	〄
sid	扦
sidz	执
sik	儒
sil	打
silz	扔
sim	扨
simd	扩
simz	扰
sin	㦔
sinz	战
sit	㡣
sits	悆
siv	悇
sivd	悈
sivz	悉
sixm	㠦
siz	〉
sk@	戗
sk@G	捴
sk@m	戒
skE	怑
skEl	捸
skI	掃
skIG	㌕
skIl	掀
skIlz	掁
skIn	掂
skIp	掄
skIps	掆
skIpt	掅
skIt	㑙
skIts	㑘
skR	坠
skRt	掇
skRts	授
skRz	坡
skY	掑
skYz	捹
sk^	䎓
sk^Gk	掐
sk^l	掉
sk^st	䎖
ska	戩
skaC	內
skarf	戕
skat	戨
skcr	戧
ske	或
skel	我
skept	䘂
sker	戓
skerd	戔
sket	捵
skets	捷
ski	嘤
sko	㜦
skord	戦
skot	冂
skoz	㜧
skr@	户
skr@C	戵
skr@Ct	戶
skr@m	戱
skr@ts	噠
skrI	扆
skrInz	朡
skrIp	奷
skr^	扉
skr^b	扇
skr^bd	扈
skr^m	扐
skrcs	䈢
skre	戴
skrep	戲
skrept	戳
skri	戹
skriC	扁
skrim	戸
skrimz	所
skrin	扃
skru	扄
skrud	扅
sku	戣
skul	奴
skup	戤
skut	戥
skw	昉
skwEr	斔
skwI	昔
skwIS	昒
skwISt	易
skwId	昅
skwIn	昆
skwR	昈
skwRm	昇
skwRt	昑
skwaS	斕
skwaSt	斖
skwc	斗
skwer	斒
skwerz	斓
skwi	料
skwik	墈
skwiks	昀
skwikt	斘
skwil	昁
skwild	昂
skwiz	昃
skwizd	昄
skx	抑
sl@	掔
sl@S	掗
sl@m	排
sl@md	掓
sl@mz	掕
sl@pt	掖
slEpt	搅
slI	搙
slIG	搖
slIGk	搕
slId	搉
slIk	搈
slIp	搗
slIps	搠
slIpt	搘
slIs	榒
slR	搲
slW	搦
slWC	搥
slY	搒
slYd	搐
slYdz	搑
slYm	搔
slYs	搇
slYt	搓
sl^g	搰
sl^m	搱
sla	搢
slaS	搣
slab	搡
slat	搤
slev	掘
sli	䁁
slik	掙
slip	㌗
slips	搀
slit	搁
slits	搂
sliv	搃
slivz	搄
slo	搧
sloz	搩
slu	搆
slx	䉱
sm@	搴
sm@k	搳
sm@n	䐄
smE	摁
smEl	搹
smEld	摀
smElz	摂
smIT	摇
smY	摆
smYl	摃
smYld	摄
smYlz	摅
sm^	摖
sm^C	摓
sm^S	摔
sm^St	摕
smar	搸
smart	搷
smc	搶
smcl	搵
sme	䐅
smo	摉
smok	摈
smor	摒
smu	摑
smuD	摐
smxs	㦆
sn@	摙
sn@C	摨
sn@Ct	摩
sn@k	摗
sn@ks	摘
sn@p	摥
sn@ps	摧
sn@pt	摦
snI	堇
snIf	摴
snIp	摵
snIps	堈
snIpt	摶
sn^	撈
sn^f	撇
sn^g	撉
sn^k	撆
sna	撃
snat	撂
sncr	撁
sncrt	撀
sne	摤
snek	摢
sneks	摣
snel	摠
snelz	摡
sni	摱
snik	摰
sniz	摲
snizd	摳
sno	摹
snod	撅
snoz	撄
snups	摷
snuz	摸
so	ㅲ
sod	抇
sok	撒
sokt	撓
sol	攃
sold	攂
son	抈
sop	撔
sor	攙
sors	攧
soz	抉
sp@	䜹
sp@Gk	攱
sp@N	攲
sp@n	攰
spE	䘃
spEk	䘰
spEks	攸
spEkts	䘲
spEl	敂
spEn	敄
spEnd	敃
spEndz	故
spEns	捲
spEnt	敆
spI	㌣
spIl	敐
spIld	救
spIlz	敒
spIn	敓
spInz	敖
spIt	敗
spIts	敘
spOl	敨
spOld	敩
spRd	焁
spWt	斁
spY	效
spYk	敉
spYnz	敕
spYr	剁
spYs	敇
sp^G	斑
sp^d	斐
sp^n	敲
sp^nJ	敱
spa	斀
span	䅢
spand	愔
spar	攵
spat	䡙
spats	敹
sper	攴
spes	攩
spi	䈡
spid	敀
spidz	敁
spik	收
spiks	攷
spl@	敠
spl@S	教
spl@St	敡
spl@k	敧
spl@t	敢
splEn	散
splI	敤
splIS	敥
splIt	敦
splen	䘵
splo	䘷
spok	数
sport	敷
sports	數
spozd	䙀
spr@t	斂
sprE	䙂
sprEd	㔄
sprEdz	斄
sprIG	斅
sprIGz	斆
sprInt	斈
spre	斃
sprus	斉
spul	敳
spulz	整
spun	敵
spunz	敶
spx	㌡
st@	昗
st@S	噢
st@k	偰
st@ks	偱
st@kt	昖
st@mp	昣
st@n	㦗
st@nd	春
st@ndz	昧
st@ns	昤
stE	昸
stEd	剃
stEm	晇
stEnt	䙄
stEp	晈
stEps	晐
stEpt	晉
stEst	㕒
stI	攗
stIG	㠆
stIGg	䐑
stIGk	䐐
stIGks	晘
stIGkt	䐉
stId	㠅
stIk	㤖
stIks	晔
stIl	晖
stIn	㙦
stInt	䄡
stR	㑠
stRd	悗
stRz	䁡
stUd	晧
stWt	晵
stY	朄
stYl	晕
st^	晡
st^G	會
st^f	朁
st^ft	朂
st^k	最
sta	晙
stak	㒃
stam	晤
stamp	晢
stampt	晣
stap	䑃
staps	晰
stapt	晩
star	昨
starC	昩
start	昱
starts	昲
starv	昳
starvd	昴
starvz	昵
starz	昰
stc	奲
stcl	昢
stcr	晴
stcrm	晳
ste	昕
steJ	昘
sted	昶
stek	昹
steks	晀
stel	昡
sten	昙
ster	映
sterz	䑓
stez	昷
sti	㑡
stil	晁
stilz	時
stim	晃
stimd	晄
stin	慡
stip	晅
stir	晆
stiv	晑
sto	晥
stol	晠
stonz	晦
stor	晱
storz	晲
stov	晶
str@k	䐓
str@kt	䙆
str@kts	䐔
str@p	晹
str@ps	暁
str@pt	暀
strE	暐
strEC	暉
strEGk	暆
strEGkT	暅
strEs	暇
strEst	暈
strIG	㉶
strIGz	挲
strIp	暒
strIs	嘆
strO	䍒
strYk	暑
strYp	暓
strYpt	暔
str^	暘
str^k	䍓
str^kt	䄢
str^m	暙
strc	暂
strcG	暗
strcr	䙇
stre	䡈
stren	晸
strenJ	晷
strend	愘
stret	䌵
striks	暃
strim	䑔
strit	嘅
strits	暄
stro	䡴
strok	暕
strol	暖
strx	剄
strxs	䍣
stu	晒
stul	晨
stx	む
stxd	奇
stxlz	䉇
stxm	䔸
stxmd	い
stxn	印
stxns	剂
stxnt	䄠
stxnz	卩
stxz	兴
su	抆
sud	朖
sum	㌰
sumd	㌱
sun	攖
sup	攤
sups	攥
sus	抅
sut	㑦
suts	㑧
suz	朗
sw@m	朩
swE	朳
swEl	杅
swEpt	杆
swEr	朲
swEt	朴
swI	杈
swIC	杓
swICt	杔
swIG	材
swIGz	村
swIS	杒
swIm	杇
swImz	杉
swRd	堓
swUS	杖
swa	木
swc	䞀
swcn	朰
swcnz	朱
swe	恘
swi	朹
swip	朷
swips	杀
swipt	朸
swit	杁
swits	杂
swo	杕
sx	〘
sxk	月
sxl	㜨
sxld	煕
sxlz	㜩
sxm	㍘
sxmd	㘑
sxmz	奅
sxn	爀
sxnt	判
sxnz	呖
sxs	朧
sxz	ㅂ
t@	㌹
t@C	㌴
t@Ct	㌵
t@G	悑
t@Gk	杵
t@S	嘥
t@b	杠
t@bz	条
t@d	杢
t@g	杣
t@gz	杤
t@k	㌷
t@ks	桡
t@kt	㌸
t@l	剦
t@m	東
t@n	坕
t@p	杷
t@ps	构
t@pt	枃
t@s	㡳
t@t	枅
t@z	枇
tE	㈩
tEk	怂
tEks	处
tEkst	䄩
tEkt	态
tEl	栃
tElz	栄
tEm	扷
tEmpt	栅
tEn	㍁
tEnT	栆
tEnd	妀
tEns	剆
tEnt	䄧
tEnts	䄨
tEr	枕
tErz	枖
tEst	怃
tI	ち
tIG	す
tIGz	䥱
tIJ	瀖
tIS	戰
tId	〲
tIk	㈱
tIks	㈲
tIl	桨
tIlt	桧
tIm	桩
tImz	桱
tIn	㍅
tIns	㌧
tInt	刹
tIp	䉓
tIps	桴
tIpt	桳
tIs	㠣
tIst	䉧
tIsts	䌷
tIv	つ
tO	梁
tOz	椒
tR	っ
tRb	䐕
tRd	㢒
tRf	㠑
tRm	标
tRmz	栈
tRn	厇
tRnd	愣
tRnz	堦
tRz	ㅙ
tSI@	㤴
tSR	扂
tSRt	朵
tSRts	朶
tUS	楔
tUk	梑
tUt	梗
tW	椑
tWl	椉
tWlz	椐
tWn	䑕
tY	䖓
tYd	桤
tYl	桦
tYm	㉁
tYmz	攈
tYn	榘
tYnz	榙
tYp	楩
tYr	䖔
tYrd	愢
tYrz	桶
tYs	䖒
tYt	㉖
tYts	桥
tYz	噷
t^	慐
t^C	椄
t^Ct	椅
t^G	梇
t^Gz	梈
t^b	㑱
t^f	椆
t^g	楒
t^gd	楓
t^k	楐
t^kt	楑
t^m	权
t^mz	杄
t^n	梅
t^nz	梐
ta	倴
taG	梆
tad	梀
tak	桹
tam	梃
tamz	梄
tan	䡠
tap	䅳
taps	梘
tar	倓
tarts	枆
tc	杧
tck	坱
tcks	杩
tckt	杨
tcl	杰
tcr	椁
tcs	椂
tcst	椃
tct	枒
te	䄤
tek	嘄
teks	杦
tel	䅦
telz	来
ten	䄣
tend	䄥
tenz	䄦
tep	杸
teps	枂
tept	杹
tes	析
test	枈
tests	枉
tet	䘄
tets	列
ti	で
tiC	枓
tiT	枙
tim	枔
tin	䕉
tinT	䜈
tinz	慰
tir	瀢
tis	林
tiz	て
tli	㒑
tmInt	も
to	㥀
tod	桵
told	梂
ton	䅉
tor	梙
tord	椇
tordz	椈
torn	椀
tos	桸
tost	桷
toz	嘰
tr@	椕
tr@S	椢
tr@k	㍃
tr@ks	椓
tr@ns	椠
tr@p	䖖
tr@pt	椡
trE	䄲
trI	䕓
trIC	坣
trIk	䄂
trIks	㒔
trIkt	椩
trIm	椳
trIns	䖕
trIp	椴
trIpt	椶
trIs	㦙
trO	䍑
trW	楀
trWt	楁
trY	椨
trYd	椰
trYk	椲
trYz	椱
tr^	椤
tr^Gk	楄
tr^Gks	楅
tr^St	椣
tr^k	䍔
tr^ks	楂
tr^st	楆
tra	䕘
tram	椷
trc	椥
trcf	椹
tre	䄁
tred	椔
treld	椖
trelz	椗
tren	奓
trend	椘
trenz	椙
tret	䄀
tri	䅶
trigd	剑
triks	堤
tris	堣
trit	椦
trits	椧
triz	䅵
tro	䄵
trol	䄳
trold	䄴
trolz	䄶
tru	楃
truT	楇
trup	椸
trx	㡴
trxl	嚇
trxm	改
trxmz	杶
tu	剐
tuT	梕
tub	楈
tubz	楉
tud	㍂
tul	梒
tulz	梓
tun	㡥
tunz	㡦
tur	䍘
tut	朇
tuts	梖
tuz	枑
twElfT	楘
twElv	楙
twEn	楠
twEr	攀
twI	楢
twIG	楣
twIs	楦
twIst	㎐
twR	楥
twRl	楤
twY	楧
twYs	楡
twi	楖
twiks	楕
twin	㕔
twit	楗
tx	〱
txd	㜷
txl	㑶
txld	抄
txlz	㔑
txm	㐨
txmz	㙰
txn	㒓
txnd	㠓
txns	扶
txnt	删
txnz	㠕
txs	夡
txst	䚇
txz	䊄
u	䘔
up	坆
ups	均
v@	䘆
v@m	瀀
v@n	瀂
v@nst	ゐ
v@nz	瀃
v@t	瀇
vE	杗
vEJ	瀈
vEl	瀐
vEm	圈
vEn	ゑ
vEnt	䘈
vEnts	妃
vEs	剓
vEsts	瀓
vI	づ
vIC	㜳
vIG	ぉ
vIGz	咗
vIZ	栂
vId	䌅
vIk	瀔
vIl	堳
vIn	䕤
vInT	䕥
vInz	匸
vIs	䌆
vIst	偗
vO	瀙
vOs	瀘
vR	㈖
vRd	䆄
vRn	瀒
vRs	愥
vRz	㒕
vW	䍢
vY	ゔ
vYn	䐙
vYnz	瀕
vYs	ん
vYts	剔
vYv	朦
vYz	吤
v^z	瀆
va	䉲
valvd	剕
valvz	剖
vcl	瀠
ve	ぢ
vel	瀑
velz	瀉
ven	瀅
vi	䄷
vil	愤
viz	噄
vo	䍡
vol	瀡
vrI	䚆
vri	䘉
vrum	瀣
vx	ㆅ
vxl	䍙
vxld	捕
vxlz	捑
vxn	䍠
vxnt	偧
vxnz	傐
vxs	嚄
vxt	妑
vyR	㔤
vyu	堵
w@	瀤
w@g	瀦
w@k	灶
w@ks	灖
w@m	灹
wE	灣
wEb	灤
wEbz	䁦
wEl	灲
wEn	炆
wEnt	灳
wEnz	灥
wEr	㍗
wErz	楶
wEst	喈
wEt	灵
wEw	炉
wI	䐒
wIC	炐
wID	焲
wIG	搨
wIGk	桲
wIGz	焤
wIS	焰
wISt	焱
wIdT	焓
wIg	焕
wIk	焑
wIl	焘
wIld	焗
wIn	焠
wInd	無
wIndz	焢
wInz	塐
wIp	炕
wIs	焀
wIt	焂
wR	厙
wRT	煒
wRd	䕃
wRdz	㄃
wRk	充
wRks	煆
wRkt	煄
wRld	炘
wRldz	煇
wRm	刦
wRmz	煈
wRnt	灴
wRs	煐
wRst	煑
wU	焇
wUd	允
wUdz	煁
wUf	煂
wUl	焷
wUlf	然
wUp	焉
wUs	煘
wW	㚄
wWnd	煓
wY	炔
wYd	焒
wYf	焔
wYl	啦
wYld	焖
wYn	炑
wYp	焥
wYps	焨
wYpt	焦
wYr	㐴
wYrz	焩
wYt	䔢
wYz	坤
w^	坂
w^n	㈹
w^ns	坁
w^nt	瀸
w^nts	灀
w^nz	䘑
w^t	炀
w^ts	炁
w^z	灅
wa	㥒
waC	灒
waCt	灓
waS	儵
wal	瀵
wan	瀷
wand	瀶
wants	瀹
wasp	灉
wasps	灐
wc	瀥
wcS	灆
wcSt	灈
wck	捘
wcks	瀲
wckt	瀱
wcl	瀩
wclt	瀴
wclz	瀳
wcr	灁
wcrd	愦
wcrm	灂
wcrmd	灃
wcrn	灄
we	㉂
wek	㍕
weks	瀨
wel	灷
welz	灸
wer	㉄
werd	炈
werz	灢
west	灑
wet	瀧
wev	喆
wevd	灔
wevz	灕
wez	㉃
wi	单
wid	灗
widz	灦
wik	灡
wiks	灨
wil	灘
wilz	炅
win	倶
winz	灩
wir	灙
wird	灱
wit	炃
wiv	灠
wiz	灰
wo	焄
wok	焵
wont	焹
wor	煃
worn	煉
wu	煀
wuS	焐
wum	焸
wup	焆
wups	焈
x	〔
xb	〡
xd	塗
xl	ぱ
xlz	㢖
xm	㉸
xmz	嘈
xn	呉
xnz	呐
xp	榅
xs	㌘
xst	晗
xts	䍱
xz	㊂
y@G	煰
y@Gk	煨
y@Gks	煱
y@Gkt	煩
y@k	煣
y@ks	煤
y@m	煦
y@mz	照
yE	熂
yEl	熃
yEld	熄
yElz	熅
yEp	熆
yEs	熈
yEt	熐
yI	熑
yIG	㉤
yIn	剧
yIpt	熓
yIr	吷
yR	䜗
yRd	䜕
yRz	䜖
yU	䘅
yUr	爅
yUrz	爆
yYks	熒
y^	爉
y^G	䕇
y^k	爈
y^ks	爐
y^m	爒
y^p	爕
ya	煡
yan	熘
yard	䙹
yarn	煲
yat	煢
yaz	煷
yc	煵
ycl	煥
ycn	煳
ycnd	煴
ycr	熙
ycrk	爁
ye	煶
yeps	熇
yi	煸
yir	煹
yirz	熀
yist	熁
yo	熔
yok	熗
yu	㊈
yuT	爇
yuZ	榓
yud	䄱
yul	爂
yur	爃
yus	榑
yuv	爄
yuz	啖
yuzd	榁
yx	㕩
yxl	䊗
yxm	焙
yxnd	場
yxnz	喗
yxz	恃
z@	爗
z@g	爣
z@k	爖
z@kt	䘕
z@m	䘘
z@n	ㅄ
z@ps	爘
z@s	䎑
zE	坳
zEG	爠
zEn	愈
zI	䁖
zIG	ㆃ
zIg	爢
zIk	剢
zIlz	㑕
zIn	䆂
zInd	案
zIns	奸
zInt	偠
zInts	她
zInz	䆃
zIp	榃
zIps	爥
zIpt	榄
zIs	愓
zIsts	䘧
zIt	䁂
zIts	坑
zIz	ゕ
zR	㚇
zRd	偲
zRdz	呢
zRt	䍄
zRv	䍅
zRvd	圠
zRz	戢
zUn	倡
zY	煠
zYn	䍆
zYr	䍇
z^dz	爦
z^l	愠
z^lt	愙
z^lts	愡
z^nd	䢐
z^z	爨
za	䤵
zcl	䘖
zcr	〢
ze	䀀
zev	煙
zi	㙑
zin	唒
zinz	唓
ziz	䊃
zo	爰
zon	爩
zu	爧
zum	爱
zus	爡
zuz	爲
zx	䔵
zxl	㑔
zxlz	怲
zxnt	䐣
zxs	劕
zxz	㉠
