1	划
1a	㍃
1a7	䘹
1ag	䡧
1ak	ㄸ
1akm	䄇
1al	䉈
1am	兴
1ap	䉲
1at	㠵
1e	々
1ek	㐹
1el	兰
1em	䘨
1en	㆖
1end	䙖
1er	匴
1et	呰
1i	〉
1id	噡
1ij	䡆
1ik	䔸
1il	䌵
1im	喃
1in	㔲
1ip	䠑
1ip6	唇
1ipp	向
1ir	㤶
1is	呃
1it	べ
1iz	剸
1o	㉒
1o5	㕸
1o8	厁
1od	怦
1oj	䐠
1ol	䐤
1old	䝉
1olt	䐣
1om	剖
1on	㉅
1os	咀
1ot	㔢
1s	䕂
1ss	䕅
1sss	喆
1u	䝶
1ug	塓
1ugd	䈈
1uk	䑈
1ukk	割
1up	䠄
1ur	卢
1Ã¡	䡙
1Ã¡g	吩
1Ã¡k	䜘
1Ã¡l	嘡
1Ã¡t	劑
1Ã©	㐄
1Ã©k	夙
1Ã©l	䆗
1Ã©r	圑
1Ã­	䎉
1Ã­bd	墈
1Ã­p	匠
1Ã³	㤇
1Ã³n	垄
1Ã³t	塕
1Ã¶	よ
1Ã¶g	吵
1Ã¶k	剒
1Ã¶n	䔷
1Ã¶nd	䑑
1Ã¶pp	吒
1Ã¶t	兑
1Ãº	㑡
1Ãºz	傉
1Ã¼	ぇ
1Ã¼1	䕔
1Ã¼11	如
1Ã¼j	䐵
1Ã¼jj	䥈
1Ã¼k	儩
1Ã¼l	䐢
1Ã¼lt	䚔
1Ã¼nk	䡉
1Å	㕨
1Åt	傈
2a	䙥
2ol	啅
3u	嘘
3un	唵
3Å	奴
4a	㆔
4ad	䑡
4ak	䑅
4al	儆
4alt	䡲
4am	䘕
4an	嘖
4ar	㔂
4at	㤙
4e	〘
4e8	兦
4ed	儃
4eg	䀇
4ej	㜈
4ejj	ㄈ
4ek	㤗
4el	㤀
4eld	䌅
4elt	怣
4em	䜇
4en	㉡
4ent	㡃
4er	㝙
4es	㎄
4et	㡰
4i	㢉
4id	䥓
4ig	剡
4ik	㚓
4is	䆑
4it	䥔
4o	㜘
4o5	刢
4ob	圦
4obb	䅱
4od	㘨
4odd	倠
4og	刵
4ok	㒘
4om	㌒
4on	ㄢ
4opp	呖
4or	㕢
4ors	䑦
4ot	䥢
4ott	候
4re	塥
4u	㉩
4ug	墅
4uj	䡠
4uk	䄨
4ul	㌶
4ult	㍓
4unk	䁶
4ur	䞀
4Ã¡	㎐
4Ã¡6	怄
4Ã¡66	㎉
4Ã¡j	嘈
4Ã¡jj	刷
4Ã¡k	䈷
4Ã¡l	㈀
4Ã¡n	䥧
4Ã¡r	䔨
4Ã¡rd	億
4Ã¡rt	㕀
4Ã¡t	呓
4Ã¡z	㜀
4Ã¡zz	㥧
4Ã©	㑱
4Ã©l	㎆
4Ã©p	善
4Ã­	㊕
4Ã­1	关
4Ã­7	儳
4Ã³	㊔
4Ã³c	兠
4Ã³d	啐
4Ã³t	唃
4Ã¶	ㅧ
4Ã¶5	䂓
4Ã¶54	䁑
4Ã¶k	䂔
4Ã¶n	䜒
4Ãºjt	嘣
4Ãºr	㔣
4Ã¼	剐
4Ã¼g	劒
4Ã¼k	㝖
4Ã¼ng	㠗
4Ã¼nk	㙓
4Ã¼tt	㒗
4Å±	儉
4Å±j	䙆
4Å±r	儐
55	噹
5a	㥐
5a8	䍥
5ad	䠴
5ak	塶
5al	䜳
5an	㔴
5as	堡
5at	䠥
5e	ㄶ
5ed	ㄨ
5eg	䄴
5ek	㥈
5el	䥣
5em	䜲
5en	䝗
5er	奀
5es	偶
5et	墂
5i	㐗
5i7	䐶
5i8d	包
5ir	䅄
5is	䜆
5ist	㔉
5it	㐤
5o	䍶
5o8	即
5od	䝵
5og	匸
5ok	䁰
5ol	䆀
5olc	䅙
5om	㈣
5omd	傀
5os	㌸
5ot	偔
5u	㡀
5uk	塩
5ul	㝱
5ul6	㝰
5ur	夰
5ut	䔠
5Ã¡	䈆
5Ã¡k	吔
5Ã¡m	圵
5Ã©	剩
5Ã©l	㙅
5Ã©m	䈘
5Ã©r	䘇
5Ã©rt	䖗
5Ã©t	剳
5Ã­lt	啘
5Ã³	匷
5Ã¶	㒈
5Ã¶g	堖
5Ã¶k6	嘕
5Ã¶s	夹
5Ãº	䡸
5Ãº6	倐
5Ãºj	兖
5Ãºj1t	堒
5Ãºjj	䕥
5Ãºl	䕲
5Ã¼	坥
5Ã¼g	堘
5Ã¼k	䄤
5Ã¼ng	墀
5Ã¼nk	㠐
5Å	䡰
5Åt	䠧
5Å±	䉇
6	刱
6a	㆒
6a4	䅓
6abb	䡥
6ak	匓
6al	䍦
6am	䁲
6an	䙦
6ap	䆆
6ar	䤒
6at	喉
6e	㉘
6e4	䄈
6e44	䄐
6e5	噢
6eb	䌦
6ebb	䍅
6ec	䈒
6ed	㍑
6edd	䔤
6eg	堷
6ek	䡇
6el	㐇
6eld	堆
6em	㑂
6en	䞈
6ep	夨
6er	㜄
6ert	厅
6es	㠖
6et	㐶
6ett	䒈
6i	㈠
6id	嚙
6ig	䌈
6ij	䐇
6ik	㍙
6il	㦀
6in	䈸
6int	㜠
6it	㜤
6lo	圤
6o	㔑
6o5	䤐
6od	㢘
6oj	䅅
6ok	䐡
6ol	㙒
6ol6	䅆
6old	䅁
6olt	商
6om	器
6on	厈
6ond	堉
6ont	䄅
6op	䥗
6or	䖁
6os	䎔
6ott	䔗
6u	刐
6uk	䜁
6ul	唖
6unk	䔇
6ur	㍴
6Ã¡	㈩
6Ã¡6	䡂
6Ã¡d	㒄
6Ã¡j	䀹
6Ã¡l	㡒
6Ã¡ll	㙖
6Ã¡llj	塒
6Ã¡llt	咖
6Ã¡m	卸
6Ã¡n	䅨
6Ã¡nt	噘
6Ã¡r	䠤
6Ã¡st	䙒
6Ã¡z	䍳
6Ã©	ㄅ
6Ã©7	䖒
6Ã©b	䁨
6Ã©c	䉰
6Ã©j	㝷
6Ã©jj	㎖
6Ã©k	䂅
6Ã©l	㈆
6Ã©l6	ㅦ
6Ã©lt	坒
6Ã©p	を
6Ã©t	䌓
6Ã­	ㅹ
6Ã­11	坦
6Ã­7	啩
6Ã­n	北
6Ã­nt	䜃
6Ã­t	䐂
6Ã­v	偳
6Ã³	㥡
6Ã³j	䜹
6Ã³jj	怈
6Ã³l	䄦
6Ã³lt	怐
6Ã³r	垐
6Ã³t	䁉
6Ã¶	ㆅ
6Ã¶5	䄣
6Ã¶6	䡘
6Ã¶g	䥰
6Ã¶l	夈
6Ã¶mbm	性
6Ã¶n	䁧
6Ã¶n6	䤣
6Ã¶nd	䍆
6Ã¶r	䅘
6Ã¶r5	䌳
6Ã¶rp	㤨
6Ãº	䙇
6Ãºr	㜧
6Ã¼	倵
6Ã¼g	䚅
6Ã¼k	㐃
6Ã¼n	䍐
6Ã¼ng	䚃
6Ã¼nk	㝩
6Ã¼r	匹
6Ã¼z	䄹
6Å	䅩
6Å1	䙧
6År	劀
7a	㈐
7an	喒
7e	㙘
7el	兀
7i	䚇
7id	䢒
7ip	倅
7it	坷
7og	吁
7ok	喂
7or	刲
7u	㞒
7ug	啹
7uk	䐷
7us	㈘
7ust	卲
7ut	垕
7Ã¡	㈷
7Ã¡k	唦
7Ã¡t	䍄
7Ã¶6	剆
7Ã¶8	夐
7Ã¶k	吀
7Ã¶k6	剅
7Ã¶n	䖓
7Ã¶s	厖
7Ã¶tt	䝠
7Ãº	䤰
7Ãºg	倷
7Ãºk	卂
7Ã¼g	共
7Ã¼k	げ
7Å±	垗
7Å±d	儣
8	夤
8a	㜶
8e	㝆
8e1	䒙
8eb	圁
8ef	圀
8ep	倧
8et	嘄
8i	ㅗ
8o	䒆
8on	急
8u	㡁
8Ã¡	䍀
8Ã¡c	卅
8Ã¡g	呲
8Ã¡k	兓
8Ã¡t	卆
8Ã­r	夣
8Ã­rk	偡
8Ã­rt	夥
8Ã³	剄
8Ã¶l	䁤
8Ã¶ld	厗
8Ã¶m	別
8Ãºr	㘆
8Ã¼	䕠
8Ã¼ng	嘐
8Ã¼t	䖕
8Å	傒
8Åt	匧
a	〇
a1	䜤
a4	㆓
a44	㜱
a5	㜡
a6	㌧
a6t	㉇
a8	厘
ab	䁘
ac	假
acc	㝔
ad	㝦
add	ㅄ
af	䀁
ag	各
ah	㔡
aj	㌇
ak	㕗
akk	塐
al	㍘
al6	䝱
alm	坴
als	唢
am	㜁
an	び
and	夘
ap	䄒
ap6t	䌰
ar	㡴
as	偣
ast	垁
at	ㄣ
att	呉
ayu	劃
az	㈔
azd	㙙
b	ㅁ
ba	〸
ba1	䥩
bac	否
bad	㕅
bag	䡤
baj	㝇
bak	块
bal	䠹
bam	䉘
bamm	䘱
ban	㑸
bant	啢
bar	ば
bart	冗
bas	䖔
bast	㐙
bat	㍲
be	〴
be2	怂
bed	䆖
bej	䝔
bekp	䙑
bel	䘖
belt	䘗
bem	䀲
ben	ㄩ
bend	䂉
benm	噂
benn	䑵
bent	䂄
ber	㙃
bert	䝐
bes	䂕
bet	㞂
bi	㎕
bi33d	㉠
bi6	㍡
bic	䜗
bil	䕴
bit	䦁
ble	塇
bo	ㅂ
bo6	䔔
bo6t	䐸
bod	䞃
bog	䡓
boj	唱
bok	傄
bol	㡖
bold	䚒
bolt	塈
bom	䥥
bon	う
bor	ㅔ
bort	啔
bos	奁
bot	㙡
boz	䑐
bre	呔
brr	妅
brum	噷
bu	䐨
bu6	䂀
bu6t	全
buj	䔑
bujt	䉠
buk	冄
bull	傓
bum	䕑
bun	剹
bus	䝣
bust	儔
but	円
buz	兩
bÃ¡	こ
bÃ¡1	䀸
bÃ¡c	䄂
bÃ¡d	䝁
bÃ¡j	㠄
bÃ¡jj	垆
bÃ¡k	䕦
bÃ¡l	㠓
bÃ¡l6	㢗
bÃ¡ld	䆄
bÃ¡lt	䉀
bÃ¡m	䈠
bÃ¡n	䚉
bÃ¡n1c	䐥
bÃ¡n3d	唂
bÃ¡nt	䙶
bÃ¡r	却
bÃ¡t	䂖
bÃ©	ひ
bÃ©d	㍨
bÃ©t	兕
bÃ­	印
bÃ­r	啈
bÃ³	䉡
bÃ³c	㥵
bÃ³l	䈂
bÃ¶	儑
bÃ¶g	䕱
bÃ¶l	䁂
bÃº	䔦
bÃºj	偓
bÃºjd	吡
bÃºjj	倲
bÃºjt	䜣
bÃ¼	䦄
bÃ¼6	儡
bÅ	䘡
bÅl	㜑
bÅ±	䅢
ca	ゐ
cag	䠩
cak	䑙
cam	刡
can	坡
cas	䒄
ce	㈖
ce4	䡳
ce44	㜴
cec	坠
ced	䉱
cejj	啵
cek	唠
cel	㠤
cem	偙
cer	㑥
cert	兡
ces	夸
cet	䌕
ci	て
cic	䐉
cid	䒁
cif	䘶
cig	䤖
cik	〧
cil	㥷
cim	卒
cir	刂
cit	㈇
co	㚗
co1	咑
co5	典
cod	偈
cok	㔅
col	㐆
com	䢇
con	冉
cos	䜸
cot	㦖
cott	䌒
cu	㦂
cu5	䠳
cuk	㤹
cunk	㚒
cup	䐅
cur	啱
cut	䜉
cÃ¡	㠂
cÃ¡j	䈓
cÃ¡l	䈵
cÃ¡m	䦃
cÃ¡n	䙱
cÃ¡r	倁
cÃ¡rt	倂
cÃ¡t	䅂
cÃ©	㚕
cÃ©7	䝙
cÃ©b	奄
cÃ©c	䢅
cÃ©k	䉵
cÃ©p	㢒
cÃ©r	劘
cÃ©t	䢀
cÃ©tt	劖
cÃ©z	兣
cÃ­	䑀
cÃ³	㦗
cÃ³l	䅡
cÃ³l6	卷
cÃ³lt	坤
cÃ³t	㉲
cÃ¶	偄
cÃº	嚉
cÃºr	匆
cÃ¼	噖
cÃ¼r	天
cÅ	吅
d	堗
da	ㅢ
da1	偂
da5	䄲
da6	䅵
dac	圓
dad	䍵
dak	䠠
dal	㒅
dar	兆
dat	㢙
daz	塦
de	〄
de1	嘴
de4	㖂
de5	剓
de6	㉈
de8	䙘
de8d	䆅
dec	唀
ded	䌄
deg	㤩
dej	夵
dek	堰
del	㉃
del6	䊆
dem	㕃
den	㈅
dent	㕁
der	嘹
dern	刈
des	㜥
det	ㆇ
dett	䘂
dez	䂒
dezd	ㆉ
di	ぴ
di11	㙆
di5	剘
dig	㑗
dik	㚁
dikt	㝂
dil	傘
dim	塡
din	䤕
ding	䡔
dis	㙱
dit	㑙
do	㕴
do5	䜨
do5t	䜦
do8d	䤵
dob	䂆
dobd	䄵
doc	怨
dod	㔐
dog	傔
doj	䜰
dojj	剥
dok	ㅈ
dol	㖔
dol6	冕
dom	ぅ
domp	䡑
don	䔳
dong	䡕
dop	䀠
dopt	㦄
dor	厔
dort	垅
dos	䔲
dot	㈳
dott	䉄
doz	䕀
drapp	匘
drÃ¡	䁳
du	䀈
du5	圢
duc	唶
dug	䒇
dugd	䑹
duj	䜱
duk	䑷
dul	㙐
dul6	㤔
dult	䕹
dung	呈
dunk	䉳
dup	䖂
dur	㜢
dwe	夠
dÃ¡	㚆
dÃ¡6	咆
dÃ¡k	刣
dÃ¡l	啳
dÃ¡m	坅
dÃ¡nk	䤅
dÃ¡r	䠅
dÃ¡s	刀
dÃ¡t	偢
dÃ¡z	咄
dÃ©	㘂
dÃ©5	㥇
dÃ©5t	㥄
dÃ©g	㕈
dÃ©k	㘃
dÃ©l	䁢
dÃ©r	䘳
dÃ©s	匱
dÃ©t	䈴
dÃ­	厇
dÃ­33d	卹
dÃ­7	儴
dÃ­g	儱
dÃ­t	倣
dÃ³	䦈
dÃ³8	塱
dÃ³s	塲
dÃ¶	㍇
dÃ¶g	䤑
dÃ¶k	䞖
dÃ¶m	䕵
dÃ¶n	䅦
dÃ¶nt	圠
dÃ¶r	䁥
dÃ¶s	䦅
dÃ¶tt	㕐
dÃ¶z	嘃
dÃ¼	喖
dÃ¼5	嘔
dÃ¼l	㞉
dÃ¼ng	塴
dÃ¼nk	圡
dÅ	䍴
dÅd	卤
dÅj	唙
dÅl	䚐
dÅlt	䔴
dÅr	啤
dÅs	剷
dÅt	倩
dÅ±j	䘓
dÅ±l	傆
e	ぱ
e4	㍶
e5	㥒
e6	㊇
e6t	ん
e7	ぃ
eb	㑃
ec	㑤
ecc	垀
ed	䈧
edd	䘈
eh	㥲
ej	㈱
ek	傃
el	〗
elb	均
elv	卩
em	㘰
en	㉂
enn	䚓
ep	塃
er	㞐
es	㎇
ess	䍕
et	㖙
ev	䈄
ez	や
ezd	㤰
f	䤀
fa	㡠
fa4	䄠
fad	㘓
faj	嘨
fal	傂
fan	䞅
fant	偰
far	䁐
fe	ㄱ
feb	卉
fej	儙
fek	ぐ
fel	䉁
fen	剴
fenm	垓
fer	㚀
fes	䂗
fest	噓
ff	䘀
fi	ㄇ
fi6	儒
fid	夶
fis	嘦
fit	䚙
fle	䥹
fo	㉰
fod	䄕
fog	㐱
fogd	㊑
fogz	匇
foj	㝑
fok	㤷
fok6	ㅴ
fol	偨
fom	味
fon	䎙
fond	呴
font	儵
for	㑘
forr	坲
fot	䝤
fra	䍙
frap	奂
fri	䍖
friss	噃
fu	䠡
fuj	㒂
fujj	䈅
fur	占
fus	塢
fuss	䡅
fut	䞑
fÃ¡	㌀
fÃ¡6	怤
fÃ¡j	㊂
fÃ¡js	嚘
fÃ¡jt	䐧
fÃ¡k	塤
fÃ¡n	䌤
fÃ¡nd	偩
fÃ¡nk	垑
fÃ¡nt	㘥
fÃ¡r	怇
fÃ¡t	䄉
fÃ¡z	䚄
fÃ©	㡳
fÃ©5	䌧
fÃ©j	䤆
fÃ©jj	儦
fÃ©l	䀄
fÃ©l6	䀆
fÃ©lk	䦖
fÃ©r	㑁
fÃ©rt	健
fÃ³	㥀
fÃ¶	㍧
fÃ¶6	㖘
fÃ¶j	塸
fÃ¶l	㐐
fÃ¶ld	㞅
fÃ¶lk	嘤
fÃ¶n	女
fÃ¶nm	䝳
fÃ¶nt	坶
fÃ¶r	㐈
fÃ¶z	ㅵ
fÃº	䚗
fÃºj	䘄
fÃºjd	䈉
fÃºjj	䘅
fÃºjt	倰
fÃ¼	ㄒ
fÃ¼g	䐓
fÃ¼k	噒
fÃ¼l	分
fÃ¼r	䁱
fÃ¼s	㙗
fÃ¼st	刔
fÃ¼z	ㅶ
fÅ	㑳
fÅ6	呥
fÅz	堂
fÅ±	䈩
fÅ±z	䉂
fÅ±zd	䉃
ga	㎔
ga4	㉱
ga6	㊉
ga6t	區
ga7	䑗
ga8d	呐
gacc	㥅
gad	㝨
gaj	噆
gal	㕲
gam	地
gard	㥱
gas	㔵
gass	㜓
gat	㈒
gaz	䎘
ge	㉢
ge1	刹
ge4	㝲
ge5	㌂
ge6	㤐
ge7	兘
ge8d	嘙
gec	㜣
gecc	䥄
ged	ど
gedd	㔹
gek	堠
gel	䔃
gelt	䢁
gem	㢀
gen	し
ges	㍸
get	㈦
gett	冀
geyer	䙄
geylj	㜒
gez	圔
gi	㑅
gi1	㐸
gi6	䥡
gic	呷
gig	㍕
gind	偉
gint	㑲
gis	㌗
go	ㄡ
go8	匙
god	䒃
godd	噅
gog	㡗
goj	匒
gojt	圄
gok	䌶
gol	䎗
gold	垂
golt	怕
gom	㥴
gomb	䈣
gon	㖓
gos	䄑
gost	墐
got	䌖
gott	㘒
goz	䊇
gra	啦
grÃ¡	剣
gu	㕕
gu4	噰
gu6	䒓
gunk	㕙
gus	㘕
gÃ¡	ㅓ
gÃ¡5	䙗
gÃ¡6	呠
gÃ¡6t	㐘
gÃ¡d	啥
gÃ¡j	㙁
gÃ¡l	䒗
gÃ¡ll	䉶
gÃ¡llt	䤁
gÃ¡m	䅒
gÃ¡n	䤧
gÃ¡r	ㅃ
gÃ¡s	䞒
gÃ¡t	㜕
gÃ¡z	㐢
gÃ©	㉐
gÃ©5	㉣
gÃ©5t	嚇
gÃ©6	㔖
gÃ©b	唔
gÃ©k	墑
gÃ©n	䈖
gÃ©p	䑧
gÃ©r	䘰
gÃ©r6	䠸
gÃ©rd	圩
gÃ©s	㞆
gÃ©t	䈑
gÃ­	䖃
gÃ­1	䙢
gÃ­7	䔉
gÃ­d	堣
gÃ­t	倉
gÃ³	㕦
gÃ³1	喔
gÃ³8	塆
gÃ³k	啕
gÃ³l	怔
gÃ³s	䞂
gÃ³t	塂
gÃ¶	䔙
gÃ¶5	剨
gÃ¶5t	䐔
gÃ¶8	其
gÃ¶r	㉙
gÃ¶t	啂
gÃ¶tt	劁
gÃ¶z	䄓
gÃº	䑁
gÃº6	唅
gÃºt	䠃
gÃºz	夑
gÃ¼	㥔
gÃ¼t	妘
gÅ	䅧
gÅt	唒
gÅz	切
h	㢐
ha	ㄘ
ha4	䁙
ha4d	䘆
ha5	千
ha6	䊙
ha7	䌂
hacc	も
had	䈁
hadd	㔶
hag	倘
haj	㙲
haj1t	妑
hajj	处
hal	㖉
hal6	圱
hall	䅤
ham	㥑
hamm	㤒
han	㕔
hang	㉓
hap	䥱
har	䒕
has	头
hat	ぷ
hatt	䒉
haz	嚈
he	㌰
he5	吧
he6	䄰
he7	倴
hecc	䤗
hed	䉣
hej	䉙
hek	倒
hem	噧
hen	䠰
her	刃
hes	㍦
het	㍤
hez	䁃
hhm	卧
hi	っ
hig	㔥
hin	㦙
hipp	墄
hit	唨
hiv	㡹
hjuj	倔
hjÃ©	㤁
hm	㞔
hmhm	䕧
hmm	䐑
hmmm	䜥
ho	〤
ho4	ゕ
ho6	㢓
ho7	㒐
hoc	䅠
hod	圲
hods	嘢
hoj	嘆
hol	〆
holt	䌴
hom	㝤
hon	䀑
hop	㤲
hop6	妇
hopp	䝩
hor	啷
hord	吸
hos	态
hov	䝸
hoz	㘹
hozd	ㆁ
hrrr	吗
hrÃ¡	噸
hu	䔀
hu6t	奘
huh	刓
huj	䁀
hul	匐
hum	㎙
hun	䜈
huzd	套
hÃ¡	㘙
hÃ¡1	塔
hÃ¡5	䅹
hÃ¡6	䦐
hÃ¡c	䝘
hÃ¡d	㤂
hÃ¡k	匂
hÃ¡p	䜖
hÃ¡r	㠀
hÃ¡s	㌉
hÃ¡t	ㅙ
hÃ¡z	䀨
hÃ©	㜵
hÃ©6	内
hÃ©l	厙
hÃ©m	坩
hÃ©n	䌗
hÃ©r	㌠
hÃ©t	䅸
hÃ©z	㦔
hÃ­	す
hÃ­f	䡱
hÃ­r	圇
hÃ­v	䐄
hÃ³	㙂
hÃ³c	䈡
hÃ³z	怠
hÃ¶	㘳
hÃ¶g	䥲
hÃ¶r	吴
hÃ¶s	墕
hÃº	㦓
hÃº5	䝰
hÃº6	䐒
hÃº6t	䒀
hÃºs	㉄
hÃºst	怉
hÃºz	䕐
hÃºzd	历
hÃ¼	㤢
hÃ¼m	奤
hÅ	䍂
hÅs	坄
hÅ±	䀉
i	ざ
i4	㈓
i6	䡨
i7	偵
i8	䑳
id	呙
idd	䑃
ig	噶
ij	㙹
ik	塷
il	䝲
im	垈
in	ㄹ
in1	奦
ip	契
ir	䀧
is	㊓
it	㉵
itt	〒
iz	㔀
ja	ご
ja1	䜅
ja5	䝅
jack	坹
jad	㒃
jag	䔈
jaj	〃
jak	䐈
jak6	嘇
jam	䌃
jan	㖅
jap	坢
japp	䑂
jas	䎅
jat	䘉
je	゗
je1	䙀
je4	堢
je5	㕡
je6	傇
je8	呦
jebb	塹
jec	䘵
jed	㘧
jej	㙷
jek	䐕
jel	䠖
jelt	㌳
jem	㌱
jen	ゑ
jepp	儠
jes	㉹
jet	㙸
jett	䌲
jez	呣
jhuj	吖
ji	㜗
jig	䀙
jik	㊈
jin	堕
jit	夃
jo	䆉
jo66	値
job	䉗
jobb	㠢
jod	兗
jog	㞘
jok	䔧
jol	䉤
jom	䚘
jon	㢃
jopp	嘅
jott	㌁
joz	嚂
ju	㊅
jug	䑲
juj	㝵
juk	㌥
jul	㚉
jult	她
jum	䌥
jung	䉑
junk	㝓
jus	唐
jÃ¡	㍵
jÃ¡5	夷
jÃ¡6	吐
jÃ¡8	䠔
jÃ¡c	㙴
jÃ¡cc	䜀
jÃ¡d	剰
jÃ¡g	偃
jÃ¡j	匲
jÃ¡k	㑖
jÃ¡l	㊒
jÃ¡n	㦈
jÃ¡r	䘧
jÃ¡r6	呹
jÃ¡s	儸
jÃ¡st	刧
jÃ¡t	㘢
jÃ©	㖀
jÃ©4	呸
jÃ©c	䢄
jÃ©g	䀷
jÃ©k	坘
jÃ©l	㝉
jÃ©n	䘠
jÃ©nt	䙕
jÃ©s	刨
jÃ©t	㍗
jÃ©z	失
jÃ³	ㄔ
jÃ³1	䞁
jÃ³c	劕
jÃ³d	䁵
jÃ³j	圳
jÃ³k	㙉
jÃ³l	ㆃ
jÃ³s	傐
jÃ³t	ㅸ
jÃ¶	䂁
jÃ¶5	圕
jÃ¶6	䅃
jÃ¶66	䂃
jÃ¶d	䥑
jÃ¶g	妓
jÃ¶j	䄘
jÃ¶m	㝗
jÃ¶n	㥖
jÃ¶t	䁁
jÃ¶tt	㕆
jÃ¶zz	怡
jÃº	䘦
jÃºj	䔢
jÃ¼g	夅
jÃ¼k	㘩
jÃ¼l	堦
jÃ¼nk	㠰
jÅ±k	啀
k	䍑
ka	【
ka1	䡢
ka4	変
ka6	儇
ka8	䦔
kab	㙳
kac	䀦
kad	ㅥ
kag	㑰
kaj	噁
kak	嘷
kal	䅰
kam	゙
kan	䀐
kap	㒙
kap6	䥠
kapj	喕
kar	㍖
kar6	㖃
kard	㌘
kart	䕘
kas	㡷
kast	倇
kat	㑵
katt	㑹
kaz	刁
kazd	怃
ke	ㄲ
ke1	䜔
ke4	㙶
ke44	䉢
ke5	偐
ke6	儢
ke6t	倳
ke8	吕
kec	㜳
kecc	利
ked	ㄥ
keg	墘
kej	㝈
kek	㘀
kel	㔨
kel6	堲
keld	䙔
kell	㉨
kelt	䠕
kem	㈴
ken	倨
kend	倀
ker	䔄
kerd	䌣
kert	塣
kes	㖖
ket	ㅲ
kez	吂
kezd	嘓
kezz	㎒
ki	へ
ki6	唡
ki8	い
kic	䀢
kicc	夆
kid	䑘
kif	䚕
kig	坕
kij	兤
kik	䍱
kil	䙲
kilt	匣
kim	吳
kin	嘸
kin1	墉
kinm	噱
kinn	剶
kint	䀴
kip	兹
kir	外
kis	㑩
kit	㤥
kiz	䕁
kla66	夕
klass	怑
ko	ㅒ
ko1	䤱
ko4	塉
ko44	䍔
ko5	䝷
ko6t	㔃
ko8	䤙
koWU1i	倖
koc	㕶
kocc	儓
kod	㐉
kodd	䎁
koj	䙠
kok	刦
kol	䌀
kol6	倗
kolt	咕
kom	䆙
kon	偁
kop	㎂
kor	㒀
kos	㔘
kot	㙢
kott	䙵
koz	㠑
kozz	䉉
kri6	奈
kro	傗
krÃ©	䄡
krÃ©m	吤
ku	〓
ku1	〔
ku8	怆
kuk	偗
kul	䕉
kung	䔆
kunk	厂
kus	㘘
kuz	删
kÃ¡	㉷
kÃ¡5	偅
kÃ¡5t	噕
kÃ¡6	夗
kÃ¡8	剁
kÃ¡bb	㙠
kÃ¡d	㘖
kÃ¡j	䢙
kÃ¡jj	噳
kÃ¡k	䠆
kÃ¡l	䉧
kÃ¡m	㜐
kÃ¡n	唷
kÃ¡nt	喈
kÃ¡pp	䐳
kÃ¡r	䑔
kÃ¡s	㤵
kÃ¡t	㦃
kÃ¡z	㤈
kÃ©	㄃
kÃ©6	䅇
kÃ©b	㉳
kÃ©c	䁠
kÃ©d	䚈
kÃ©g	䈙
kÃ©j	䕳
kÃ©j6	妖
kÃ©k	㌨
kÃ©l	墙
kÃ©ld	墔
kÃ©m	ㅆ
kÃ©n	儈
kÃ©nt	喅
kÃ©p	㘸
kÃ©r	ㆈ
kÃ©r6	㡈
kÃ©rd	㘦
kÃ©rt	墇
kÃ©rz	䈃
kÃ©s	䡵
kÃ©t	ょ
kÃ©z	㤸
kÃ­	劙
kÃ³	䌘
kÃ³6	厐
kÃ³c	呇
kÃ³d	䔓
kÃ³j	嘀
kÃ³k	奶
kÃ³m	儗
kÃ³r	䥶
kÃ³s	䁆
kÃ³st	奢
kÃ³t	䌢
kÃ³z	啉
kÃ¶	ㄦ
kÃ¶4	怅
kÃ¶5	䉆
kÃ¶5f	夢
kÃ¶5v	䐖
kÃ¶6	䀗
kÃ¶d	㝴
kÃ¶l	䐩
kÃ¶m	兇
kÃ¶n	噑
kÃ¶p	㝳
kÃ¶pt	䥀
kÃ¶r	䌐
kÃ¶s	冂
kÃ¶z	㐓
kÃº	䌩
kÃº7	䙐
kÃºs	怀
kÃºt	元
kÃ¼	䍹
kÃ¼4	噥
kÃ¼44	唘
kÃ¼d	㒔
kÃ¼l	卨
kÃ¼nk	㖄
kÃ¼t	㡱
kÃ¼tt	㒑
kÅ	䀒
l	兢
la	ㄳ
la1	ㄙ
la3	坳
la4	䥘
la44	㡤
la5	䖙
la5t	圃
la6	䈇
la6t	坆
lab	䍇
lac	㔇
lacc	儘
lad	㙀
lag	䡀
laj	刉
lak	䌡
lak6	䅳
lal	㘇
lam	厉
lan	䔹
lant	嚗
lap	䉹
las	㝶
lat	㊁
latt	㘔
laz	䥉
lazd	䥐
le	〵
le1	㊘
le6	㍰
lebb	噤
lec	㔸
lecc	备
led	㉉
ledd	垘
leg	㝡
lej	儲
lek	㝅
lel	㦇
lem	㝘
len	㔦
len3	䒑
lenc	㈃
lend	嘶
lenm	䝆
lenn	坵
lent	㦘
lepp	䉖
les	䖖
lesp	㠥
let	㠡
lett	㒉
lev	䡷
leyn	㥹
lez	㑠
li	㎁
li6	㔧
lic	塗
lid	䚖
lif	㡶
lig	䈗
lik	㔁
lim	偹
lin	䕸
lin1	嚁
linc	塘
lis	䈥
lit	㥁
liz	䤃
lo	䎖
lo6	䥳
lod	䁷
log	㕵
lok	㚖
lol	劓
lom	㖐
lon	䂑
lond	䡄
lop	啒
lost	塄
lot	䤓
lott	䍘
lu	㡡
lu4	䄄
lud	䎃
lug	䑸
lul	䕷
lun	䞔
lung	㜖
lunk	ぁ
lur	啨
lus	㒒
lust	䥤
lut	䀵
lutt	䢂
lÃ¡	㈸
lÃ¡5	㙩
lÃ¡5t	㦆
lÃ¡7	啸
lÃ¡WUbam	偘
lÃ¡b	吥
lÃ¡bb	㠧
lÃ¡c	䒂
lÃ¡cc	䜂
lÃ¡g	㤘
lÃ¡j	㒓
lÃ¡k	怩
lÃ¡l	㡨
lÃ¡ll	兔
lÃ¡ll6	䤡
lÃ¡llt	䡒
lÃ¡lt	䝑
lÃ¡m	㌕
lÃ¡n	㌑
lÃ¡ng	㔙
lÃ¡nt	堄
lÃ¡p	䡁
lÃ¡s	㑢
lÃ¡st	䍈
lÃ¡t	㥥
lÃ¡z	䠢
lÃ©	㘐
lÃ©4	奔
lÃ©5	吰
lÃ©5t	唥
lÃ©8	偦
lÃ©b	単
lÃ©c	づ
lÃ©g	䀩
lÃ©k	㘱
lÃ©p	㕧
lÃ©p6	䙤
lÃ©r	䘷
lÃ©s	偧
lÃ©t	䆔
lÃ©z	墓
lÃ­	䒘
lÃ­1	䘑
lÃ­33d	園
lÃ­7	䘒
lÃ³	㤑
lÃ³8	呅
lÃ³g	塑
lÃ³k	㤉
lÃ³s	㢑
lÃ³t	啓
lÃ³z	坧
lÃ¶	㘈
lÃ¶7	䤦
lÃ¶d	㠲
lÃ¶jj	㙰
lÃ¶k	ㄑ
lÃ¶l	䚀
lÃ¶m	䘙
lÃ¶n	䎀
lÃ¶s	㍷
lÃ¶t	啁
lÃ¼	䊑
lÃ¼j	䊐
lÃ¼k	匔
lÃ¼l	䊓
lÃ¼ld	啃
lÃ¼lt	奲
lÃ¼nk	え
lÃ¼r	䕣
lÅ	ㅡ
lÅ6	呕
lÅbb	㉔
lÅj	嘑
lÅl	䊒
lÅr	匨
lÅt	咙
lÅtt	㊙
lÅ±	䊁
m	㈈
ma	ふ
ma1	備
ma3	䈢
ma6	吣
ma8	㕳
mabb	増
mac	㠁
macch	䖆
mag	㚄
maj	㦒
majd	ㅇ
majt	㡉
mak	䕕
mal	䥒
mam	㝸
mamm	堙
man	刑
mar	㡦
mas	㞄
mat	㑦
me	と
me4	㈢
me44	剠
me5	ㄵ
me55	㙄
me6	䖀
me7	㍂
me8	奆
mecc	坂
med	䦓
meg	ㄗ
mej	䙁
mek	じ
mekp	剈
meks	㌢
mel	㜩
meld	堓
melt	䢕
mem	䦙
men	〨
mend	䆒
ment	さ
mer	㕖
merd	㑴
mert	㉧
mes	㥓
mest	䄢
met	㕩
mez	偒
mhm	䦉
mi	ゃ
mi33d	㌵
mi4	㡑
mi6	䘘
mi8	塀
miMIrÅl	䢘
mic	㉀
mid	䈲
mig	塁
mik	㖇
mil	堵
min	㈄
minc	䒖
mind	㠆
mint	㦑
mis	䔁
mit	〕
mix	䔖
miz	卥
mizd	卦
mki	吷
mm	充
mmmmmm	嚄
mo	㑆
mo1	大
mo4	䜴
mo6t	奖
mo8d	㝧
mod	厀
mog	䖉
moj	䝓
mojj	㡲
mok	㥣
mol	㠃
mol6	倶
mom	堧
mon	〈
mond	ゔ
mont	㊗
mor	卄
mos	㍣
most	ぉ
mot	䘔
moz	㕥
mu	㜂
mu11	夁
muk	偸
mus	䎇
mÃ¡	㔄
mÃ¡5t	䕇
mÃ¡6	偷
mÃ¡8	䅈
mÃ¡c	䠲
mÃ¡d	㘣
mÃ¡g	冘
mÃ¡j	㑕
mÃ¡l	㤧
mÃ¡m	㤖
mÃ¡n	䈕
mÃ¡nc	塳
mÃ¡nt	䦕
mÃ¡r	㍒
mÃ¡s	㜨
mÃ¡st	ㅉ
mÃ¡t	䎑
mÃ©	㌖
mÃ©4	奧
mÃ©5	㐩
mÃ©5d	周
mÃ©5t	㐨
mÃ©6	㤄
mÃ©d	䡐
mÃ©g	ㄉ
mÃ©j	䙅
mÃ©k	む
mÃ©l	坉
mÃ©n	䙈
mÃ©r	䎕
mÃ©rd	垙
mÃ©rt	䁓
mÃ©t	䔥
mÃ©z	䥦
mÃ­	䐦
mÃ­g	儰
mÃ³	つ
mÃ³t	妈
mÃ¶	䔩
mÃ¶1	䡡
mÃ¶d	䔱
mÃ¶l	剑
mÃ¶l1	剔
mÃ¶m	䔰
mÃº	䜙
mÃºl	儷
mÃºlt	呩
mÃ¼	䄀
mÅ	㍱
mÅ±	㘲
n	䉷
na	〹
na4	㌔
na7	㜷
nab	㦕
nac	㈕
nad	㥗
nag	冈
naj	卑
nak	㈵
nal	㍐
nam	䁹
nan	ㅰ
nap	㤠
nat	㝁
ne	ㄤ
ne4	㙔
ne5	坈
ne66	怘
ned	䘢
neg	䥃
nej	卵
nek	ゖ
nel	䄥
nem	ㅀ
nen	䜑
net	䙉
nez	怢
nezz	怖
ni	〣
ni1	唑
ni6	刄
nic	䀥
nid	吢
nik	䥅
nin	㆕
nin1	。
nin3	䌁
nit	䀤
niz	咉
nnem	咒
no	㐖
no6	倃
nocc	怗
nod	吲
nok	咐
nom	㐁
non	䍉
nor	䈤
nos	㞙
nozd	䆈
nu	嘗
nul	堹
nunk	堑
nwem	匳
nÃ¡	㙵
nÃ¡6	剗
nÃ¡c	呡
nÃ¡d	䝇
nÃ¡j	㑧
nÃ¡jj	ㅠ
nÃ¡jt	妐
nÃ¡k	䦀
nÃ¡l	㈉
nÃ¡l6	㄂
nÃ¡ld	㚙
nÃ¡lt	㌃
nÃ¡lz	㜰
nÃ¡m	匄
nÃ¡n	剕
nÃ¡nk	在
nÃ¡nt	吆
nÃ¡r	具
nÃ¡s	㚑
nÃ¡t	㌈
nÃ¡z	嚔
nÃ©	㔓
nÃ©4	㈹
nÃ©6	䈨
nÃ©66	㈙
nÃ©66t	奸
nÃ©6t	䌙
nÃ©7	䈔
nÃ©c	䕄
nÃ©d	䝕
nÃ©k	䎓
nÃ©l	㒁
nÃ©m	䐆
nÃ©nk	䡦
nÃ©t	䝖
nÃ©v	夡
nÃ©z	ㄕ
nÃ©zd	㆘
nÃ©zz	㎅
nÃ­	唧
nÃ³	㠳
nÃ³d	䞉
nÃ³m	䢗
nÃ³n	䢖
nÃ³r	䌑
nÃ³rt	圈
nÃ³s	堨
nÃ³t	䐙
nÃ³z	倢
nÃ¶	䍨
nÃ¶d	䤤
nÃ¶m	ㆆ
nÃ¶t	垇
nÃº4	嘂
nÃ¼	吹
nÃ¼l	䢑
nÃ¼n	噣
nÃ¼nk	咗
nÅ	䁈
nÅ1	兒
nÅ3	啧
nÅc	則
nÅjj	匵
nÅs	噀
nÅt	䠐
nÅtt	匶
nÅ±	ㆀ
nÅ±t	偤
o	㉖
o4	咘
o6	傕
od	䦇
odd	䂈
og	㘗
oh	先
oj	倥
ok	刘
ol	䂐
olt	奷
on	ㅩ
op	䑕
or	㒆
orr	夲
ors	塧
ot	䂘
ott	㈨
p	䠵
p6	䐲
pa	㔱
pa2	嘳
pa6	㡐
pad	䁴
paj	嚖
pak	匈
pal	妒
pam	奓
pan	䆇
pap	㤴
par	㤓
part	㤆
pas	啇
pat	䘐
pe	㕓
pe5	䆘
pe6	儤
pech	䍸
pej	䠷
pek	㖑
pel	䐀
pelt	址
pem	ㅳ
pen	ㄆ
per	㌲
perc	圐
pes	䌆
pest	䜢
pet	㚘
pez	吠
pezd	吙
pfÃº	夓
pi	ら
pi6	㔗
pic	堸
pig	㝣
pij	妕
pijt	妔
pil	㝀
pim	咅
pin	啰
pinc	嘁
ping	圧
pink	咂
pir	䁄
pirt	堤
pis	㍈
pit	䊘
piz	喘
pk	嚃
po	㕄
po1	䑒
po6	制
po7	喑
pod	䉸
pog	呄
poj	㌤
pok	㤦
pol	圸
polc	倡
pom	䥙
pon	咈
pond	䅗
pong	咃
pont	䅐
por	厄
port	厃
pos	䌨
pot	䊀
pott	䀂
poz	嘱
pri	䊅
prob	匕
prr	兵
prÃ³	䆃
ps8	兄
pu	㐅
pu1	嘵
puff	䕃
puj	䢃
puk	㚐
pukk	唤
pul	劂
punk	坃
pus	䝄
put	儥
pÃ¡	㤳
pÃ¡jj	坱
pÃ¡l	午
pÃ¡l6	坨
pÃ¡m	䠶
pÃ¡ns	奃
pÃ¡nz	坑
pÃ¡r	䝦
pÃ¡rt	剢
pÃ¡t	䐃
pÃ©	㠉
pÃ©6	唴
pÃ©k	判
pÃ©l	䤷
pÃ©n	匩
pÃ©n6	䑤
pÃ©n6t	䑨
pÃ©nz	䑰
pÃ­	䕩
pÃ­1	䡈
pÃ­7	䔘
pÃ­j	場
pÃ­r	䙩
pÃ­rt	偖
pÃ­t	傅
pÃ³	㕹
pÃ³1	䈶
pÃ³t	䢔
pÃ¶	䞐
pÃ¶7	厕
pÃ¶d	䦒
pÃ¶g	䁖
pÃ¶r	劄
pÃºp	吘
pÃ¼	䐴
pÃ¼j	堶
pÃ¼l	䡖
pÃ¼lt	䥖
pÃ¼n	唩
pÃ¼nk	唰
pÅ	䚆
pÅs	䎐
pÅt	䚂
r	䍢
ra	㌷
ra4	㥆
ra44	䑱
ra5	啗
ra6	圖
rabd	吱
rac	倓
racc	め
rack	剧
rad	㍥
raf	㤡
ragd	䉐
ragz	咓
raj	㌙
rajz	䠉
rak	㐣
rak6	厒
rakt	䌱
ral	㒇
ram	剀
ran	䤥
ran1	化
rant	卣
rap	䡗
ras	冖
rat	ぶ
ratt	䑶
re	〙
re2	到
re6	㢅
re6t	㥨
re8	剂
re8d	ㆄ
rec	偱
recc	䀣
red	㠘
redd	塵
reg	㘅
regj	䅴
rejt	䙂
rek	㑔
rekt	䥸
rel	㌡
rem	㄄
ren	㕤
rend	㙥
res	㡥
ress	䍒
ret	㉁
rett	卙
rezd	噦
ri	ㅨ
ri1	塰
ri44	䄸
ri6	列
ri67	奇
ri8	唹
ric	㠦
rik	㚈
ril	坐
rin	䡣
rin2	䥷
rinc	䐱
rind	圅
ring	剤
rint	㡙
rip	䠒
ris	坙
rist	堅
ro	㘑
ro1	䝢
ro5	㞇
ro6	㌐
ro66	㡔
ro8	ㆂ
rob	啡
roc	䔣
rod	䀓
rog	㍄
roj	䡹
rok	㥂
rok6	匥
rol	〢
rom	㎓
ron	㦐
ron3d	㦉
rond	㠨
ros	㌩
rot	㐑
rott	倸
roz	䉴
rra	圷
ru	㝄
rug	䙴
ruj	䥕
ruk	倆
rukk	䙙
rul	㐴
ruld	䍲
rult	㔒
runk	吃
rut	ㅣ
rÃ¡	㕷
rÃ¡5	䜕
rÃ¡6	㜙
rÃ¡7	合
rÃ¡8	䌹
rÃ¡c	堳
rÃ¡d	䉨
rÃ¡f	䝥
rÃ¡g	㥘
rÃ¡j	䤈
rÃ¡k	呂
rÃ¡l	㔩
rÃ¡l6	㡇
rÃ¡lt	匦
rÃ¡m	呵
rÃ¡n	䐰
rÃ¡s	䤢
rÃ¡t	㍩
rÃ¡tf	刳
rÃ¡v	䡶
rÃ¡z	䎂
rÃ¡zd	㞈
rÃ©	ㄠ
rÃ©5	员
rÃ©6	喀
rÃ©6t	儹
rÃ©bb	㞑
rÃ©g	䠀
rÃ©j	䦆
rÃ©k	䞙
rÃ©m	噩
rÃ©p	嚀
rÃ©s	㙧
rÃ©t	䖅
rÃ©z	唗
rÃ­	䑉
rÃ­1	奕
rÃ­11t	呤
rÃ­t	䡃
rÃ³	ゅ
rÃ³4	㥢
rÃ³8	䡴
rÃ³c	䑢
rÃ³l	㠴
rÃ³m	㕰
rÃ³s	匃
rÃ³t	㤕
rÃ³z	堈
rÃ³zz	嚑
rÃ¶	㢈
rÃ¶1	刴
rÃ¶4	啲
rÃ¶f	儀
rÃ¶g	㠸
rÃ¶j	㠩
rÃ¶k	ち
rÃ¶l	㑈
rÃ¶ld	倦
rÃ¶lt	䆓
rÃ¶m	㦅
rÃ¶p	䠨
rÃ¶s	䅶
rÃ¶t	䘤
rÃº	儂
rÃºk	坰
rÃ¼	㕂
rÃ¼j	䄱
rÃ¼jj	吉
rÃ¼l	㌅
rÃ¼l6	唆
rÃ¼ld	䁣
rÃ¼lt	㑑
rÃ¼ng	卓
rÃ¼nk	䄙
rÅ	䈐
rÅ4	夀
rÅl	䕤
rÅs	䁒
rÅ±	㈗
rÅ±bb	境
rÅ±t	䉩
s	㠶
sa	㔷
sa5	䁔
sa6	䤉
sa77	䐹
sab	塙
sabb	㔰
sac	嘧
sad	䙡
saj	䍓
sajt	䝹
sak	䊉
sakk	䑆
sal	剉
sam	㑣
san	㢖
sap	䚁
sapp	墖
sas	冇
sat	㜔
sci	塅
se	㐷
se5	䤶
se6t	唉
se8	写
seb	儕
sebb	㑀
sed	䔶
seg	㠇
sej	䊗
sek	㒕
sel	㙨
sem	㑐
sen	㎈
sepp	䊕
ser	㍆
set	倕
sett	㈧
si	㌴
si1	坓
sic	坔
sicc	坖
sid	呁
sig	䝧
sij	䢐
sijj	䢈
sik	㎀
sil	㜦
sil6	䢉
silt	㜹
sin1	㝹
sir	呒
sis	㚅
sisl	䄷
sit	㔈
ske	怙
sko	䤄
smo	創
so	゘
sod	㑇
sog	㥠
sok	㠅
sol	䤴
som	㞗
son	劐
sonk	喙
sor	䅀
sport	䍡
spric	㠣
ss	嚅
ss8	偲
st	䕈
su	嘠
sug	䁡
suj	㞃
suk	䔒
sunk	䙷
sust	儖
sÃ¡	〡
sÃ¡g	匰
sÃ¡jt	嘰
sÃ¡l	嚆
sÃ¡ll	妉
sÃ¡r	〷
sÃ¡s	䠣
sÃ¡t	兲
sÃ©	〱
sÃ©g	㘄
sÃ©j	䈱
sÃ©jj	䝀
sÃ©k	ㅑ
sÃ©l	䌇
sÃ©ld	㖗
sÃ©r	㕉
sÃ©s	啑
sÃ©t	堥
sÃ­	䑖
sÃ­m	䜠
sÃ­n	䜐
sÃ­nt	䝡
sÃ­r	㊄
sÃ­r6	㡂
sÃ­rt	墆
sÃ³	㥃
sÃ³k	圗
sÃ³t	們
sÃ¶	䌷
sÃ¶k	圣
sÃ¶n	㤤
sÃ¶p	劇
sÃ¶t	㝐
sÃº	䉅
sÃºj	刖
sÃ¼	㐧
sÃ¼7	㐦
sÃ¼77	傑
sÃ¼d	偀
sÃ¼hh	側
sÃ¼j	䆕
sÃ¼k	䕒
sÃ¼l	㐳
sÃ¼lt	十
sÃ¼ng	䥆
sÃ¼nk	㡧
sÃ¼t	倈
sÅ	䀶
sÅbb	偑
sÅpp	圆
sÅt	䤂
sÅ±	䀕
sÅ±m	䂇
sÅ±t	䀔
ta	぀
ta6	䞆
ta7	䝃
ta8d	㝒
tacc	剃
tad	㍁
tag	䥴
tak	㝥
tal	㘤
tald	㊐
talt	䄗
tam	㉶
tan	㜉
tant	冔
tap	㕑
tar	䝂
tas	䄁
tast	䑠
tat	䉥
taz	㕠
te	〰
te6	㐂
te7	け
te8	喓
te8d	䀘
tec	〦
tecc	㥉
ted	㐕
tedd	㐥
teg	㌓
tej	䡩
tek	ㄷ
tel	㞀
teld	呢
telt	䐁
tem	㘷
ten	㐒
tent	匢
tep	㔆
ter	㎃
tes	ㅐ
tess	妗
tessk	怒
test	㡄
tet	㐔
tett	㐠
tez	䆁
tezd	垒
ti	㈁
ti6	㝃
tig	唸
tik	䘩
til	圹
tin	冒
tint	冓
tip	冃
tis	嘥
tit	䦂
tiz	䀰
tlak	噇
to	㑒
to1	䘃
to4	䕗
to7	䕖
to8	協
toc	㉆
tod	㊆
todd	墒
tog	䄃
toj	䥂
tojt	圥
tok	㄁
tol	㈡
toll	嘩
tolt	唁
tom	㊖
ton	则
top	㌣
tor	㥰
tord	團
tort	䙹
tos	㍢
tot	㍀
tott	䀃
tra	噈
trak	䅥
trom	啄
trr	入
tru	䦘
tu	㈲
tu4	䁗
tu66	奨
tu7	䕙
tuc	䒅
tucc	䊄
tud	䅉
tug	㡆
tuj	唳
tuk	䈀
tul	ㅤ
tun	儧
tung	嚒
tunk	㡩
tur	䔕
tus	䒔
tust	圉
tut	㕒
tÃ¡	あ
tÃ¡5	噴
tÃ¡5t	㜸
tÃ¡6	䀀
tÃ¡8	㑷
tÃ¡b	䑇
tÃ¡d	奣
tÃ¡f	夔
tÃ¡g	䥵
tÃ¡j	䕶
tÃ¡k	㠔
tÃ¡l	〲
tÃ¡m	匁
tÃ¡n	㈤
tÃ¡r	䑥
tÃ¡rt	䎈
tÃ¡s	䄆
tÃ¡t	㔳
tÃ¡z	塠
tÃ©	ㄧ
tÃ©5	㞖
tÃ©5t	䊃
tÃ©6	㔤
tÃ©g	呧
tÃ©k	㍹
tÃ©l	㌆
tÃ©n	䦑
tÃ©nt	䂙
tÃ©p	䌔
tÃ©s	䜡
tÃ©st	㠙
tÃ©t	㝕
tÃ©z	䙸
tÃ­	劅
tÃ­7	劉
tÃ­t	劈
tÃ­z	噵
tÃ³	㤅
tÃ³1	匤
tÃ³d	䜧
tÃ³k	允
tÃ³l	㉦
tÃ³n	䕓
tÃ³s	啣
tÃ³t	䒐
tÃ³th	垃
tÃ³z	嘒
tÃ¶	㌄
tÃ¶5	奵
tÃ¶6	䤳
tÃ¶b	㞁
tÃ¶bb	㆗
tÃ¶d	㥕
tÃ¶j	奡
tÃ¶jt	奙
tÃ¶k	䆂
tÃ¶l	㐲
tÃ¶m	塖
tÃ¶n	ぢ
tÃ¶nk	㕇
tÃ¶p	墁
tÃ¶pp	䕢
tÃ¶r	㠱
tÃ¶rd	剦
tÃ¶rk	㘡
tÃ¶rt	奠
tÃ¶s	䍩
tÃ¶t	㤱
tÃ¶tt	喗
tÃ¶z	䥨
tÃº	垔
tÃºl	冐
tÃºr	堐
tÃ¼	䁇
tÃ¼6	䞇
tÃ¼g	䀳
tÃ¼k	䞄
tÃ¼n	㡣
tÃ¼ng	䚑
tÃ¼nk	䑄
tÃ¼pp	剱
tÃ¼s	䠘
tÃ¼t	奱
tÅ	㆐
tÅl	ㅘ
tÅnk	咇
tÅt	䀖
tÅ±	䖄
tÅ±6	䔐
tÅ±c	劗
tÅ±k	匀
tÅ±nt	䜩
tÅ±t	䍣
tÅ±z	䜷
u	㈑
u4	䝨
u6	䉦
u7	䙓
uc	呶
ug	䘴
uh	㎘
uj	䙨
ul	䤸
um	㘵
un	倄
unk	䄳
us	危
ut	䅷
v	䝒
va	〥
va1	䖐
va4	㉤
va5	㞕
va6	㡸
va7	㄀
va8	䉔
vac	㥶
vad	券
vag	䀅
vak	䕆
val	㒖
vam	㆙
vamt	妁
van	】
var	䘥
vard	匉
varr	䤇
vart	堁
vas	䜓
vask	夂
vat	䁅
ve	㐵
ve1	南
ve6	〖
ve6MM6Ã¼k	䖑
ve8	堀
vec	唲
ved	㡕
vedd	ㅕ
veg	䔂
vej	㙦
vek	䔵
vel	㐰
vem	㖆
ven	㍳
ver	㙣
verd	㥦
vers	刕
vert	喐
ves	で
vest	㐀
vet	㡓
vett	㢄
vi	ㅅ
vi1	啖
vi6	㆑
vic	啴
vicc	䦗
vidd	ㅱ
vik	㥩
vil	䖘
vin	䅑
virs	䎆
vis	坁
vit	〩
vitt	䤘
viz	㙕
vm	噉
vo	䐘
vol	㌹
vold	㘁
volks	噙
volt	ㄴ
vom	だ
vor	劔
vos	內
vott	妄
vu	妃
vu6	㜅
vunk	嘉
vuz	䊂
vÃ¡	〠
vÃ¡5	塨
vÃ¡8	㦁
vÃ¡bb	㑓
vÃ¡g	䘁
vÃ¡k	㥙
vÃ¡l	圙
vÃ¡n	噔
vÃ¡n6	噗
vÃ¡pp	堔
vÃ¡r	㑄
vÃ¡r6	嚕
vÃ¡rd	報
vÃ¡rj	䉕
vÃ¡rt	咔
vÃ¡s	㥸
vÃ¡t	䎒
vÃ©	㍔
vÃ©4	呑
vÃ©6	㥳
vÃ©cc	圶
vÃ©d	䤨
vÃ©g	㡘
vÃ©k	奐
vÃ©l	偆
vÃ©r	䤠
vÃ©rt	兙
vÃ©s	䈹
vÃ©t	㉸
vÃ­	圴
vÃ­6	啶
vÃ­z	䙳
vÃ³	嚓
vÃ³t	奅
vÃ¶	㤣
vÃ¶d	㢇
vÃ¶k	䂂
vÃ¶l	㙑
vÃ¶l6	唄
vÃ¶n	䄔
vÃ¶s	䅣
vÃ¼l	妆
wa	噠
x	坣
xi	䍤
xot	䖇
xÃ¡t	䜵
yhÃ¼m	奰
z	䊖
za	㉑
za1	儅
za5	䠙
za6	䄩
za6t	剙
zab	䌠
zad	吨
zaj	䜄
zak	㘴
zal	䄶
zam	䍃
zan	夒
zar	䆐
zas	卐
zat	㘠
zaz	䁕
zbad	㚇
ze	㈶
ze1	䥇
ze4	䌸
ze5	厑
ze7	䊈
ze8d	唕
zeb	夦
zebb	㝢
zec	啙
zed	㔔
zeg	㑨
zek	㖈
zel	㕘
zel6	䈦
zeld	㉴
zem	㞓
zen	㈂
zer	ㅖ
zes	㑶
zet	䔅
zett	児
zez	嚐
zi	㘉
zi8	䑓
zic	䁸
zik	㚃
zim	䞘
zin	兂
zis	㐡
zit	䀡
zit1	㕣
zitt	䍠
zo	㍠
zo5	㕱
zo6	㢂
zod	䐗
zodd	䑴
zog	䝴
zoj	偕
zojj	奩
zok	㜆
zol	㎑
zol1	妙
zol6	匡
zolt	䠈
zom	㔠
zon	㍉
zor	䅲
zott	䁩
zu	㉕
zuc	䙰
zug	冑
zuj	㔕
zuk	䑣
zum	䠁
zunk	㤃
zus	㖁
zÃ¡	㉥
zÃ¡4	䢓
zÃ¡6	䒒
zÃ¡7	圂
zÃ¡c	劆
zÃ¡d	光
zÃ¡j	垉
zÃ¡k	䠇
zÃ¡l	㢆
zÃ¡ll	䤹
zÃ¡m	倱
zÃ¡n	堇
zÃ¡nk	呀
zÃ¡r	㙈
zÃ¡rd	㑉
zÃ¡t	升
zÃ©	㈥
zÃ©d	噲
zÃ©g	㠷
zÃ©j	呆
zÃ©l	䍁
zÃ©m	㢁
zÃ©n	䠓
zÃ©p	呱
zÃ©r	呗
zÃ©rd	㖒
zÃ©rt	㠹
zÃ©t	䐐
zÃ­	傁
zÃ­7	卡
zÃ³	㠒
zÃ³m	䍷
zÃ³s	唓
zÃ¶	㍅
zÃ¶6	㠕
zÃ¶k	堃
zÃ¶l	ㅷ
zÃ¶ld	㜲
zÃ¶lt	㥤
zÃ¶r	倹
zÃ¶s	刅
zÃ¶t	堩
zÃ¶tt	噐
zÃº	䞓
zÃºd	唈
zÃºg	䠗
zÃºj	䕰
zÃºt	䠂
zÃ¼	㠈
zÃ¼g	喁
zÃ¼k	ㄖ
zÃ¼n	夳
zÃ¼nk	ㄓ
zÃ¼st	䘸
zÃ¼z	㙇
zÅ	䈰
zÅd	冁
zÅt	䈳
Ã¡	㡵
Ã¡4	儨
Ã¡5	㚂
Ã¡d	䞗
Ã¡g	䙃
Ã¡j	卶
Ã¡l	㊀
Ã¡ll	㈰
Ã¡ll6	儶
Ã¡llj	䢆
Ã¡llt	啠
Ã¡m	㎗
Ã¡p	吶
Ã¡r	䤔
Ã¡rd	傖
Ã¡s	吓
Ã¡t	㢔
Ã©	㄰
Ã©8	〳
Ã©d	䝈
Ã©g	单
Ã©j	䜶
Ã©k	䙣
Ã©l	喇
Ã©m	㡢
Ã©n	㌦
Ã©p	䔡
Ã©r	㖕
Ã©rt	㊃
Ã©s	ゆ
Ã©t	䄧
Ã©z	怓
Ã­	䠦
Ã­4	、
Ã­7	㜃
Ã­c	厓
Ã­r	偠
Ã­r6	坸
Ã­rt	垖
Ã³	䅔
Ã³1	唣
Ã³g	䊔
Ã³h	䖈
Ã³k	䑩
Ã³t	䎄
Ã³z	奥
Ã¶	㠠
Ã¶5s	䅕
Ã¶6	㉗
Ã¶66	嘲
Ã¶d	奒
Ã¶h	奉
Ã¶k	䘣
Ã¶l	䤲
Ã¶m	䤩
Ã¶n	䕡
Ã¶n1	䅖
Ã¶r	䞕
Ã¶s	噄
Ã¶t	䍧
Ãº	䉒
Ãº1	㜇
Ãº4	㘶
Ãº6	䌉
Ãº7	㙤
Ãºc	㚔
Ãºj	䕨
Ãºk	䥁
Ãºr	吇
Ãºs	咁
Ãºt	䍰
Ã¼	ㄐ
Ã¼4	卖
Ã¼8d	妀
Ã¼d	儁
Ã¼j	䀱
Ã¼jj	䉓
Ã¼l	㝠
Ã¼l6	㢕
Ã¼lt	〶
Ã¼s	䁦
Ã¼t	䘲
Ã¼z	䄖
Å	㡅
Åk	匑
År	䠱
Åt	䍗