tachi: plural pronoun
kata
gata: plural pronoun (formal)
domo: humble
ra: makes pronoun informal
bu: magazines, newspapers, packets of paper (ichibu, nibu, sanbu)
dai: cars, bikes, machines, appliances (ichidai, nidai, sandai)
pai
hai
bai: cups, glasses of drinks, (ippai, nihai, sanbai)
piki
hiki
biki:small animals, fish, amphibians,reptiles, oni (ippiki, nihiki, sanbiki)
kai
gai: number of floors, stories in a building ( ikkai, nikai, sangai)
ko: small obkects (ikko, niko, sanko)
mai: flat objects: paper, photos (ichimai, nimai, sanmai)
mei: people(polite) (ichimei, nimbi, sanmei)
nin: people(except 1, 2) (hitori, future, tannin)
tsu: general counter (hitotsu, futatsu, mitsu)
satsu: books (issatsu, nisatsu, sansatsu)
wa: stories, episodes (ichiwa, niwa, sanwa)
pon
hon
bon: long cylinders, pencils, pens, bottles (ippon, nihon, sanbon)
chaku: clothes (icchaku, nichaku, sanchaku)
sara: dishes, plates (hitosara,futasara, sansara)
ji: hours (ichiji, niji, sanji)
byo: seconds (ichibyo, nibyo,sanbyo)
fun
pun
bun: (ippun, nifun, sanbun)
gatsu: month (ichigatsu,nigatsu, sangatsu)
haku
paku: nights stay (ippaku, nibaku, sanpaku)
jikan: hour long periods (ichijikan, nijikan, sanjikan)
ka: day of the month (tsuitachi, futsuka, mike)
kagetsu: monthlong periods (ikkagetsu, nikagestu, sankagetsu) 
nen: years (ichinen, ninen, sannen)
nichi: day: ichinichi, ninichi, sannichi
sai: age (issai, nisai, sansai)
shu: weeks (issue, nishu, sanshu)
ban: place/position, first, second third (ichiban, niban, sanban)
do: degrees (ichido, nido, sando)
-san: title: mr./mrs./ ms.
-sama: title, higher rank individual
-kun: male child
-chan: child
-bo: endearment, child
-senpai: senior colleagues
-sensei: teachers, experts, doctors, lawyers 
-shi: unfamiliar person
onna-: woman, female
masu: is (verb)- tabemasu- to eat
mashita: was- tabemashita- ate
masen: not- tabemasen- will/do not eat
masendeshita: did not- tabemasendeshita- 
ru: dictionary form: taberu- to eat
nai: negative tabenai: not eat
nakatta: past negative-  tabenakatta- did not eat
katta
kunai
kunakatta
ko- little, small
dai-great
sa- little, nice
shoo-small, little, minor, tiny
kyuu- former, ex, 
mai- every
sai: most
ma: intensifies word
han: half
zen: entire
shin-new
mi-not yet, un
chou- super
-kiru: verbal suffix
-shoo: elementary schools
-sui:water, liquid
-shin: heart
-jun: order, sequence
-ka: -ize, -ify
-nen: year
-nichi: day
-en: $
-do: degree
fuu: style, appearance
ryuu: style-like
teki: -ish, -ive, -ic, -al
butsu: thing
sei: ness, ity
