1	゗
1c	䀷
1n	も
1ns	ゃ
1s	㙣
2	㌨
2c	㥀
2s	䁅
3	ざ
3f	ㄩ
3fs	䍤
3s	㉠
3ss	䔵
3x	㉢
@	ㅧ
@s	㕐
A	〦
Ad	䍔
Af	䅠
Ak	㐀
Al	㐗
Als	䁷
Alt	ㄈ
Am	㈴
An	〄
Anc	䕶
Ancst	䎓
Ans	䎆
Ant	㑄
Ap	㙂
Ar	㊃
Arm	䄃
Art	㜦
Axt	䘇
C@	䔳
CA	㈧
CLn	㤥
CYs	㑙
ChIC	㙄
ChR	㊒
Chim	䔧
E	ㄵ
Eks	䌲
El	㜀
En	㊖
Enc	㠖
Ent	㈉
Er	㌇
Erd	㜷
Es	ㄧ
Et	㍤
I	ㅣ
IS	㜨
Ic	〥
Im	㊁
In	㄃
Ins	㐓
Ir	㐇
Is	䉧
Ist	べ
J@	䅈
JI	㜃
Ju	㑉
L	䀧
Ln	䆁
M	㦁
N	じ
Ns	䒈
O	㌦
Oft	㖇
Ok	㈸
Op	㒒
Opst	䁑
Or	䀳
Ord	䊄
Os	㜇
Ox	䒖
P1	㝉
P1ft	䑙
P3	䙦
P@	㠧
PI	㚃
PIc	㚂
PL	㘕
PN	㠂
PR	䖓
Per	㌹
Pert	㊈
Pl3	䍠
PlA	䕥
PlY	䙠
PlYkt	ㄗ
R	と
Rn	㤕
Rst	㡩
Rt	䅲
S1nt	䈄
S2	䒘
S2s	䌰
S3	ど
S3n	ㅇ
S3t	㊗
S@	゙
S@s	䅢
SAT	㈥
SAf	䀁
SAr	㘥
SArf	䖃
SAx	ㄓ
SE	㑶
SET	䔶
SEn	㝔
SEnk	㑕
SEnkst	䐖
SEnkt	䉳
SI	䄐
SIc	㡵
SIf	㤣
SIk	䈤
SIkt	㦙
SIlt	㢗
SImPst	ㅨ
SImPt	䙵
SIr	䘸
SLn	䙁
SN	ㄅ
SO	䊔
SOs	䍖
SU	㉩
SUp	㔹
SUpst	䁲
SY	㎖
SYr	㡙
Sa	㜣
Saf	㖔
Sar	䎗
Se	䍥
Sef	䘣
Si	㢉
Sif	㕡
Sipt	ㆆ
Sir	㙆
Sit	㜢
Sl1	䕷
Sl2	㖅
SlA	㤦
SlAn	䁁
SlEc	䍙
SlEct	䀈
SlI	䅧
SlIm	䔆
SlIngt	䌇
SlUkst	㙔
SlUs	䀗
SlYs	䄄
Sla	ㆀ
Slaf	㐱
Slef	㘔
Slefst	㥁
Sleft	㌢
Slis	㑅
Slus	䐥
Sm1	ㆈ
Sm1s	㈡
Sm1st	䍗
SmA	㡹
SmE	㝇
SmEkt	䉙
SmIs	㚘
SmU	䄧
SmUk	䄀
Smi	䊘
Smir	䉄
Smirn	䒕
Smirs	䎅
Smirst	䈷
Smirt	㡦
Smu	㉨
Sn1	䎁
Sn1t	䈳
SnA	䄖
SnAps	䁦
SnE	㡅
SnEl	㝴
SnI	䀡
SnQ	〸
SnU	㈇
Sna	䁀
Sne	䅖
So	䌘
Son	〒
SpA	䐆
SpAn	䐔
SpI	䄂
SpIT	㍱
SpU	䘀
Spe	䄰
Spert	䎕
Spi	㤩
Spil	つ
Spilt	ち
SprE	㜸
SprI	䔒
SprIT	䒂
SprITt	䈣
SprIn	䂒
SprIngt	䁡
SprOx	䕴
SprUn	䅅
Spu	㈲
Sq	㦉
Sqn	㈦
Sr1	㘂
Sr1b	㡒
Sr3	㢑
SrAk	䘃
SrAnk	㐘
SrE	䕢
SrEk	䌦
SrI	䐡
SrIf	䐂
Sri	䅂
St1	㔃
St1c	䂆
St1gt	䂇
St1n	䍘
St3p	㥸
St3t	㉴
St@	䅣
StAnt	䍲
StArk	㒈
StAt	䔡
StE	㘒
StEk	っ
StEkt	㡠
StEl	㠒
StElst	䕀
StElt	〰
StEn	䊃
StIct	䕲
StIf	㢂
StIft	㊉
StImt	㌴
StInk	䄈
StInkt	㡆
StN	䔂
StOf	㕓
StOr	䘳
StOrc	䁂
StOx	䑃
StUs	䐧
StYk	䈶
Stap	䒐
Ste	㎑
Ster	㐣
Stest	、
Stet	ぅ
Sti	㔓
Stqr	䘧
Stqst	䍵
Str1	㝥
StrAs	䅘
StrEn	ㅂ
StrI	㍲
StrIk	㍨
StrUmP	㠆
StrYm	㠦
Stul	㎂
Sty	㚈
Styl	㚆
Su	㌡
Sv1	䈃
Sv1n	㖒
SvA	䘩
SvAnT	䐢
SvApt	䒆
SvAr	㢀
SvArT	䀒
SvI	㤆
SvIm	䄣
SvImt	㝳
SvIn	䉘
SvO	䅃
SvOm	䖙
SvR	㍢
Svan	䄡
Svapt	䐸
T1	㕖
T1c	㉧
T1g	䁒
T1gt	㕕
T1t	㑨
T2	䄤
T2c	㍩
T@	㌲
T@s	㢁
TAk	㑒
TAnkt	㢙
TE	䅁
TEl	㕃
TElt	㥂
TEpt	䁩
TI	㐲
TIc	㌗
TIg	䀤
TIr	䆑
TIs	䆀
TL	㥖
TLt	䄵
TN	〗
TO	㌀
TR	䄦
TRn	㝗
TU	䘱
TUn	㑹
TUnc	㤹
TYn	䔉
Tan	㤧
Te	ぐ
Tel	㢕
Tels	㘗
Telst	㘠
Telt	㤅
Ten	㈶
Ter	ㄖ
Ti	㈀
Tilt	㑆
Tim	䁥
Tin	㠗
Tir	䐇
Tirt	㥥
Tis	䈥
Tist	䘗
Tit	䂘
To	㊂
Tq	㦂
Tu	ㄸ
Tuc	㉘
Tum	ㅄ
Tur	㍘
Tv1	㌑
TvAk	䕈
TvAn	䈠
TvAr	㡀
TvE	䄨
TvI	㄄
TvIk	䕇
TvIkt	㞉
Tvan	䀣
Tverc	䖒
Tvi	〘
Tvurm	䍄
Um	㔈
Umf	㈓
Un	㍈
Unc	㑲
Uns	㍕
Unt	う
a	ㅵ
an	〷
ar	㕹
b1	㌅
b1m	㈳
b1n	䁗
b1s	㍗
b1st	䄘
b2	㢃
b3	㜩
b3m	㎀
b3mt	䅥
b3r	㘧
b3t	䊕
b3x	㘲
b@	㑩
b@r	䙑
b@rc	㘹
b@s	䙳
bA	㊘
bAk	〙
bAl	㖓
bAlt	䀖
bAm	㥩
bAnk	䒄
bAnt	㔆
bAst	䌵
bAt	䄶
bE	㊕
bElt	㥢
bEnt	㘃
bEs	㈃
bEt	㐔
bI	㉇
bIl	㈱
bIlt	㑔
bIn	㍥
bIs	㌃
bIst	ㅙ
bL	〹
bLn	䑆
bLt	䖇
bM	䁃
bN	㊀
bNt	䖑
bOrt	㔒
bR	ㅶ
bRn	䑐
bRt	䁣
bU	䈧
bUm	䆅
bUn	㎃
bUrc	䖗
bUs	䆖
bYr	䍧
ba	㙷
ban	㉉
bant	䘹
bar	㚀
bat	䘶
bax	㝕
be	㕩
ben	䙙
ber	㙘
berc	䅳
bi	㉕
bin	䖐
bir	䌗
birs	䙃
birt	䅐
bis	㞁
bl1	㠷
bl1p	㤑
bl3	㝐
blA	䊅
blAt	䀆
blE	㎄
blEt	䘰
blIc	㕢
blOk	䍉
blOs	㔅
bla	䊆
bles	䎐
bli	䒓
blings	㉀
blq	䙣
blqt	䐱
blu	䉒
blut	䖄
blym	䐵
bo	䁧
bqk	䙤
br3	䎘
br3n	䀉
br3x	䄆
br3xst	䁨
br3xt	㑁
brA	䘑
brAf	䉈
brAnt	䙈
brAs	䄓
brAxt	䔹
brE	㔐
brEmst	䙗
brEt	䊁
brI	㍖
brIc	䔀
brIn	䀃
brInc	㤃
brIngt	㜙
brQk	㍡
brY	䁹
bra	㡗
bri	㜐
brif	㜂
bro	䉡
brot	䈨
brox	䐃
brq	䉐
brqt	䒅
bu	䀹
bums	䔱
burt	㦑
bux	ㅆ
by	㊑
byc	䎉
byl	䔣
c1	㜉
c@	㊙
c@s	ㅕ
cElt	䀓
cLn	㝦
cLt	䑣
cN	぀
cNt	㜹
cR	㒔
ca	䉴
ci	䐁
d1	を
d1m	䑱
d1n	ぉ
d1ns	䈩
d2	㐡
d3	㘴
d@	ㅡ
d@s	䍡
d@st	㒘
d@t	㒅
dA	〃
dAn	ぶ
dArf	㌐
dArfst	〲
dAs	〱
dAx	㕥
dAxt	㉱
dE	ㄤ
dEkt	㈐
dEn	ㅓ
dEnkst	䉔
dEnkt	ㅷ
dEs	䍴
dEst	䄉
dEt	㙁
dI	㉃
dIc	㍴
dIk	㘳
dIn	㌁
dInc	䈕
dIngs	㚓
dIngt	㕇
dL	㄁
dN	㍓
dO	㕣
dOk	䕡
dOl	㌰
dOx	㈕
dR	〔
dRn	㔥
dRs	䅑
dRt	䅵
dU	㡶
dUm	䍦
dUn	䌅
dUr	㜈
dUrc	㜶
dYn	䐲
dYr	䘢
da	㜱
daxs	䙇
de	㘀
dem	〵
den	【
der	々
di	ぴ
dil	㌸
dings	㐂
dir	㆕
dirs	䐶
dis	䅸
do	㥑
dof	㢅
dr1	㘆
dr3f	ぱ
dr3s	䌸
dr@	䉅
drAn	ㅹ
drE	䀕
drEk	䍈
drI	䂈
drIn	㙳
drR	䅉
drUn	㠕
drY	䀔
dre	㡐
dret	䂔
dro	䑂
druk	㎘
drun	䑄
dry	㚔
dryk	㤒
du	。
dul	䈅
dur	㕳
durc	䔸
e	㒑
en	䙲
er	㆘
erb	㔂
erst	㔔
f1	䑠
f2	䆗
f3nt	䌑
f@	ㅴ
fA	㉶
fAl	㤰
fAln	䐀
fAn	㉹
fAnc	㥵
fAnt	ㅉ
fAs	㥐
fAst	ㄆ
fAx	㈠
fE	䕹
fEl	㠐
fElst	㔄
fElt	䅓
fEm	㌓
fEn	䔓
fEngt	䑑
fEs	し
fEst	㍐
fEt	䎈
fI	㜄
fIS	㌩
fIlm	䑦
fIn	㈘
fL	㎆
fLn	㝆
fN	ㆁ
fO	㥶
fOl	〕
fOm	㐰
fOn	づ
fOr	㈖
fOrt	䄹
fQ	㦖
fR	㤵
fUn	㤄
fUrct	㙹
fY	䑕
fYlt	䑈
fYnf	䁵
fa	㉔
fals	䐠
far	䅆
farb	䐕
fe	㝵
fel	䘒
felt	䍳
fer	〠
fert	㞙
fi	㌘
fil	㎐
fir	㍦
firt	㔉
fl1S	㦆
flA	㑧
flE	㠙
flES	㡕
fli	㤳
fligt	㝱
flo	䑹
flus	䘄
flux	㢒
fo	㍸
fol	䁠
folc	㌈
fon	㊆
for	㖙
fq	㍃
fr1	㥴
fr2	䔩
fr2m	䆒
fr2n	䕖
fr2st	䔤
fr2t	㤠
fr3	㙧
frAgt	䌴
frAxt	㒁
frE	ㅔ
frEc	䄗
frEs	䄔
frI	゘
frIS	䈑
frIT	䘴
frIst	㞀
frOS	㤢
frQ	䘆
frYc	䘅
fra	㜗
fry	㕈
fuks	㌣
fum	㡉
fur	㜲
fus	㍑
fy	䖔
fyn	㡤
fyr	む
fyrn	䈘
fyrs	䈒
fyrt	㐉
fys	䀲
g1	㑰
g1n	㜘
g@	〩
g@p	䌡
g@s	䅒
gAn	〖
gAnT	㍇
gAnc	䐈
gAns	䁆
gAr	䒇
gE	㞃
gEl	㆒
gElp	䁳
gElt	㦀
gEn	㐴
gEnd	㔣
gEnt	㐈
gEs	㕷
gIn	㘸
gInc	䘂
gInt	㚄
gIp	㕴
gIps	㑢
gIpst	㑣
gIpt	㘙
gIpts	䎀
gL	㍄
gLn	㝤
gLt	䌕
gN	㌤
gNs	㐩
gNt	ㅃ
gR	㈙
gRn	㦃
gU	㊓
gUk	〢
gUkst	䖅
gUkt	㊐
ga	䅡
gal	㙒
gan	䕦
ganc	䐣
gar	ㅸ
gas	䙱
ge	㐠
gent	䀴
ger	㙇
gern	䕄
gest	㑘
get	ㅗ
gets	㉳
gi	䙢
girt	䎑
gl1	㕱
gl1c	㔙
gl3	㙑
gl3p	㙗
glAt	䖀
glI	㡥
glIc	䉲
glInc	䑡
glO	䍂
glQk	䘤
glYk	㕧
glYkt	䑳
glas	䐴
gles	䚁
golt	䎂
gons	㥘
grAt	䁇
grIf	䕸
grUnt	䐦
gras	䍁
grop	㥡
gros	㉂
grq	䌈
grqs	䖁
gru	㔷
gry	䐨
gryn	䁴
grys	䔨
gu	㙖
gur	䍑
gurt	䁐
gut	ㄢ
gyp	䉶
h1	㐒
h1n	䌁
h1s	㎕
h1st	㑐
h1t	㒕
h2	で
h2s	㞇
h3	䆃
h3pt	㒇
h3s	㡇
h3t	䍹
h@	㥠
hA	ㅑ
hAl	㕰
hAls	㜧
hAlt	㤖
hAm	㤸
hAms	䖘
hAn	㠣
hAnd	㠡
hAns	㒃
hAnt	㆑
hAp	〤
hAps	䍱
hApt	㘖
hAr	䈴
hArt	䈰
hAst	〉
hAt	㈄
hAts	䖈
hE	㊄
hEft	䀠
hEl	䁕
hElt	㈂
hEm	䕐
hEmt	䂙
hEn	㌠
hEnc	㥉
hEnd	㝰
hEngt	㙃
hEnkst	㙅
hEnkt	䀑
hEt	䕃
hEtst	䒗
hI	㦘
hIl	䂖
hIlf	㍙
hIlfst	䘖
hIlft	䖂
hIm	㘵
hIn	〨
hIr	䀰
hO	䌐
hOf	㖁
hOl	䍃
hOlT	䍆
hOpst	㥲
hOrst	㖃
hOx	䉇
hQr	䙶
hQrn	䀸
hU	㥃
hUPst	䈔
hUn	㠅
hUnt	㉅
hY	㥄
hYP	㥒
hYPt	䔷
hYlt	䈂
ha	す
han	㤶
har	䐓
has	〶
he	㞘
her	㍔
hern	て
hert	䔄
hir	ㆇ
ho	㉲
hof	䆕
hol	㐙
holst	㤂
holt	㑤
horn	䘓
hq	㝲
hqr	䍇
hqrn	䑰
hqrst	䅀
hqrt	〴
hu	䘈
hun	㉁
hup	㢐
hut	䄱
hy	㘄
i	㈅
im	㕵
in	㉷
ir	ㆂ
irt	㤙
j@	䌄
jA	〈
jATt	䂓
jAnc	䕨
jAng	䌣
jETt	ゔ
jEk	㔧
jEkt	㒓
jI	䕧
jN	䌶
jUm	䒉
jUn	㉥
ja	䄴
jar	ㄇ
je	㙥
jekt	㖕
jo	㝁
ju	䆄
k1	㙕
k1n	㎇
k3	䅤
k3f	䈱
k3fs	䑘
k3ft	㦇
k@	ぷ
k@s	䙨
kA	㌱
kAl	䂗
kAlt	㒀
kAm	䆇
kAmP	㥇
kAn	㆗
kAns	䎄
kAnst	ㄣ
kAr	㉓
kAs	ㄴ
kE	㎈
kET	㊔
kElp	䍀
kElt	㘩
kEmt	䉨
kEnst	㘱
kEnt	㒖
kEst	㠹
kI	㔁
kIT	䔢
kIc	㦐
kIn	㔶
kInt	㝧
kIr	㤘
kIs	䈐
kL	ㄥ
kLn	㕙
kLt	㘣
kN	ㅀ
kO	㐖
kOP	㐃
kOm	〇
kOmst	㑡
kOmt	ㄒ
kOn	㢆
kOrp	䈢
kQ	㕘
kQn	㜤
kQnt	䁄
kQr	㔩
kR	㐤
kRt	䐄
kU	䍶
kUnst	㡲
kUrT	䔰
kUt	䅹
kYs	㕶
ka	㜆
kam	㠵
ke	䊐
keks	㤡
ker	㝢
kern	䉓
ki	㥳
kirc	㠇
kl1	ㄘ
kl1n	䀅
kl1t	㝘
kl3	䒑
kl3n	㡰
kl3s	䉁
klA	㝒
klApt	㡢
klAr	㔤
klE	㔇
klEmt	䍩
klI	䕅
klIc	㎓
klOPt	䔠
klQ	㜴
kle	㖆
klept	䉷
klert	䐷
klq	㝖
kn@t	䔃
knA	㦓
knAks	䂐
knAlt	䕩
knEct	䌆
knI	㘢
knOP	䑲
knOx	䔁
knQ	䑉
knY	䄸
kna	㍳
knect	䕕
kni	䊓
ko	㌷
kon	䊈
kq	㝣
kr1	䘷
krA	䌉
krAn	䕰
krAnk	䖖
krAx	䂄
krAxst	㞆
krEm	䔇
krO	㌶
kra	㡖
kraxt	䔴
kri	㠉
kric	㐕
kricst	䉣
krict	㤲
krigt	䌧
krq	㢘
ku	㉆
kus	ぃ
kux	㞔
kvA	䘔
kvACt	䄥
kva	䁓
kvak	䙥
kver	䑨
kvikt	㜅
ky	㐳
l1	㑵
l1ct	㞈
l1mt	㉣
l1n	㤨
l2	䆘
l2fst	䘙
l2ft	㥣
l2t	㍠
l3	㘐
l3t	䌥
l@	ば
l@s	〧
lA	㝙
lAm	㙰
lAn	㔠
lAnc	䙕
lAng	䉸
lAngt	㙨
lAs	㑈
lAx	㞅
lAxst	䔈
lAxt	㝨
lE	ㅈ
lET	㘅
lEk	䉦
lEkt	䍅
lEnc	㑳
lEncs	䑩
lEncst	䙐
lEst	䂕
lEx	䁱
lI	㞒
lIc	㔀
lIct	ㅘ
lM	㕁
lN	び
lO	㐧
lOk	䙔
lOn	䑖
lQ	㡴
lR	㈈
lRn	䖕
lRt	䍷
lU	㡂
lUft	䉆
lUn	㠢
lUngs	㜠
la	䈆
lan	䔖
lant	䙸
lat	㝀
le	䀐
lec	㙸
lecs	䐅
lecst	䐗
lect	䂀
legt	䘦
lep	䘁
lernt	㜓
let	䑤
li	㈩
ligt	㝡
lin	㝈
linc	䖆
lip	㠄
lirt	䍓
lis	䐑
list	䔑
lit	㤓
lo	ㅒ
los	㐄
lot	䕱
lox	㡄
lq	㝷
lym	䅶
m1	こ
m1n	ㅢ
m1ns	䄁
m1nst	㥦
m1nt	䚀
m2	䈇
m2s	ぁ
m3s	さ
m@	ㆅ
m@s	㡷
mA	㑇
mAc	㤀
mAcst	䍐
mAks	䍸
mAl	〣
mAls	䊉
mAn	㈢
mAnc	䑧
mAnt	㠱
mAr	あ
mArk	䅱
mArkt	䉕
mAs	䒔
mAx	ゕ
mAxs	㐷
mAxst	ゑ
mAxt	ㅖ
mAxts	㐹
mE	㘡
mET	䌩
mElkt	䘥
mElt	䙘
mEn	㎔
mEnS	䆉
mEnt	㘉
mErt	㊅
mEs	䈲
mI	㉦
mIS	㖈
mIc	め
mIlc	䅔
mIn	㒗
mIst	䑴
mIt	ぢ
mItm	䊇
mL	㉈
mLn	䉩
mLt	䙖
mN	ㅦ
mOl	䑇
mOnt	㥗
mOr	㠃
mQ	䉱
mQx	ㅰ
mQxt	㑑
mR	ㅐ
mU	ㄐ
mUmps	㙶
mUn	䊗
mUnt	】
mUs	㍶
mUst	㄰
mY	㚁
mYl	䙒
mYs	㕠
mYst	䈀
ma	㈤
mal	㡱
malst	㡔
malt	㙩
man	䕣
me	㌳
med	㉸
mer	㉙
merkst	䊑
mi	㕅
mil	䌃
mir	㌉
mis	㕔
mo	㘈
mon	㥰
mq	䚂
mu	㜔
mun	䉵
my	ㅠ
myl	䙓
myn	䅷
myr	䑀
mys	䈉
myt	㞑
n1	㑸
n1n	㆙
n2	㐁
n2n	㈵
n3	㐥
n@	ご
n@s	㑓
n@t	䎒
nA	㒙
nAk	㠁
nAn	㉡
nAs	㖗
nAx	㊇
nAxt	䙉
nAxts	㍹
nE	㑥
nEc	䑗
nEnt	㙤
nEst	㍆
nI	㜕
nIc	㜒
nIct	〳
nIcts	㉑
nIg	䉥
nIl	䀨
nIm	㢇
nImst	㉗
nInc	䌤
nIs	㕒
nIx	䅦
nM	ん
nN	ㆃ
nO	㌆
nOm	䑷
nOr	䁰
nOrd	㖀
nOx	ㄠ
nQs	㝂
nR	ㄡ
nRn	䑒
nRst	䎃
nRt	䌔
nUn	㒂
nUnc	㖂
na	ㅥ
nas	㦅
ne	ㆄ
nem	㆐
nh1m	䁤
nhAl	䙄
nhAst	䄇
nhof	㘨
nhun	㌔
nhy	ㄷ
ni	㝑
nirt	㥷
nis	䕳
no	㌒
nord	䁔
nq	䅗
nu	㕸
nuc	䉢
nul	㕨
nund	䀢
nur	ㅩ
nus	䌙
nygt	䒀
o	㈔
on	㜖
p@	㙱
pA	ㄹ
pAk	䉑
pAkst	䀘
pAkt	䌷
pAl	䘉
pAm	㞐
pAr	㡈
pArkt	䙀
pArt	䄑
pAs	㌵
pAst	㠓
pE	䍒
pEn	䐘
pIc	䀇
pIlT	䕤
pIm	㘷
pImp	䆙
pImpt	㠴
pL	㘶
pLn	㠶
pN	㔸
pO	㑂
pOst	㉒
pR	㔰
pRt	㝓
pU	㙴
pUT	㙵
pUTT	䁖
pUTt	〡
pUk	䑓
pUr	㥕
pUt	㍰
pYnkt	へ
pYp	䕁
pa	䄙
par	㥔
pe	䙆
per	㆓
perlx	䅨
pi	㠤
piT	䕔
pikst	㉖
pips	䑔
pir	㠰
pirt	䀀
pis	䅕
plA	䁢
plAC	䑢
plAT	㚉
plAt	㙢
plE	䌢
plQT	䉀
plUm	䀵
pla	㉰
plaT	䆓
plu	䀶
po	㈑
pr1s	䎖
prI	㤤
prIl	䘲
prO	㥤
prac	㒉
pri	㚒
pro	㕲
prqst	䀙
pru	䊂
pu	㝹
qf	㔡
r1	㠨
r1ct	䉠
r1f	㙈
r1g	㕑
r1n	ぇ
r1s	䐤
r2	䅩
r2m	㠸
r2mst	㠠
r2mt	㠥
r3	㖄
r3b	や
r3f	㚐
r3m	䎙
r3s	ふ
r@	㈆
r@s	㦕
rA	㔳
rAn	䅇
rAnt	䈵
rAps	䍰
rAt	㠀
rEct	㔕
rEk	䔙
rEkt	㈣
rEs	䈸
rI	㜡
rIT	䍕
rIc	ょ
rIn	䘠
rInc	㢄
rIs	㎉
rM	㍅
rN	㐐
rO	䄕
rOlt	㞖
rR	㍒
rU	䄷
rUC	䔐
rUCt	㡨
rUn	㉵
rUnc	㘁
rUnt	㥙
rY	䄩
rYk	䍣
rYkt	㠘
rYs	䀦
ra	䀩
rak	㒐
ral	㑦
ran	䙡
rat	䄠
rax	䔲
re	ㅳ
reg	䖉
ret	䐳
ri	㍣
ricst	䒁
rict	㡳
rinc	㙐
ring	㥆
rins	䐒
ro	㈨
ror	䊙
rot	㦈
ru	㔲
ruC	䍢
rufst	䕵
ruk	䕙
rum	㤴
rus	䙷
rut	㡧
ry	䔥
st1	䘕
st1n	䍨
st3	䘨
st@	㞂
st@s	䁉
st@t	䁶
stAc	㦒
stAgs	䕉
stAl	䎔
stE	䑶
stElt	䁈
stEn	㚕
stErn	㞄
stI	䄢
stIc	㡃
stIm	㔦
stImt	㘦
stM	㖐
stN	㑴
stNs	㥨
stR	㑱
stRn	䈈
stRt	䐙
stUnc	䙧
stY	䔔
stYk	䅙
stens	㜁
sti	㘰
stun	䔕
sty	䔗
t1	ㄙ
t1c	䘡
t2	㝃
t2s	䂁
t3	㔴
t3rt	䒒
t3xt	䅄
t@	ㄳ
t@s	䈙
t@st	ㅱ
t@t	䊀
tA	㙀
tAc	䌂
tAn	㤉
tAnTt	㝄
tAp	䕆
tAs	㞗
tAt	䀂
tE	㤷
tEm	䕓
tErt	㎅
tEst	㡣
tEt	㐵
tI	㑷
tIS	㡓
tIc	よ
tIm	䙅
tL	ㄔ
tLst	㑖
tLt	㎗
tN	㈷
tO	㙠
tOP	㤁
tOl	㖑
tOr	㌄
tR	ㄑ
tRm	㦗
tRn	㚇
tRs	㔢
tRt	㥱
tUnc	䆈
tUrm	㠈
tUx	㚑
tY	䌖
tYp	䌀
ta	㘇
tal	㙡
tam	䌓
tan	䁸
tax	㌕
te	ㄶ
ter	㝠
ti	㌧
tir	ゅ
tirt	㕤
to	㈹
ton	㐶
topt	䂑
tor	䒙
tos	㠑
tot	䁘
tq	㕄
tr3	䉰
tr3t	㤐
trA	䌳
trAm	㥈
trE	㢈
trIn	䁙
trInk	䌠
trInkt	䀱
trO	䈖
trOT	㚅
trUn	䐹
tre	㜳
tri	㈒
tro	䉃
tu	え
tun	㌖
tur	䘘
turm	㜰
turnt	䈹
tus	䈡
tust	ㄦ
tut	ゆ
tux	㠳
ty	㚙
tyr	〆
u	㘤
um	㆖
un	㕆
ur	㎁
v1	㉤
v1l	ㄉ
v1ls	㙦
v1nt	㤗
v1p	㠔
v1s	㡁
v1st	㙓
v1t	䔅
v@	㦄
vA	ㄲ
vAl	㔗
vAlt	䌹
vAn	䐐
vAnt	㔑
vAr	㈁
vArm	䑵
vArn	䎇
vArs	䑅
vArst	㢔
vArt	㢓
vAs	ゐ
vAx	㍂
vAxt	䂃
vE	䈓
vEc	け
vEk	䄲
vEl	㒆
vElS	㥧
vElc	䘵
vEn	ㅤ
vEns	䈁
vEs	䐰
vI	㑀
vIS	䌱
vISt	㞕
vIc	䆐
vIl	㍧
vIlst	㐑
vIlt	䂉
vIn	㄀
vInkt	㑠
vIr	㎒
vIs	㎙
vIst	䌨
vN	㝸
vO	ㅅ
vOl	㖖
vOlf	䙰
vOlst	㥓
vOlt	䉂
vOr	㐢
vOrt	㒄
vOx	㦔
vQl	䙹
vQr	㌙
vUm	䆆
vUn	䙴
vUnt	䈦
vUrm	㙲
vUrst	䌒
va	㙙
van	㜑
vas	䔘
ve	ら
vecs	䕗
vem	䐉
ven	㘘
ver	㉄
verk	䑥
vert	㐆
verts	㕀
vi	〓
vir	ゖ
virf	㡘
virst	㞓
virt	ㄕ
vo	㈰
vol	䄒
von	䆂
vont	䔦
vos	㘑
vy	ㆉ
y	㐨
z1	㝅
z1m	䕘
z1n	㜥
z1t	㖉
z2	䂂
z3	㐸
z3gt	㥹
z3s	䙂
z3st	䐩
z@	だ
z@s	㚗
zA	㕂
zAT	䉉
zAft	䅰
zAgt	㌂
zAl	㔘
zAm	䉹
zAmt	㙉
zAn	䑁
zAnt	䊖
zAt	䊒
zAx	㔨
zE	㑗
zET	㤇
zETt	䒃
zEc	䀥
zEl	㝩
zElbst	䈗
zEn	㐅
zEnt	㔵
zEp	䕒
zEs	䆔
zI	㑃
zIT	㤈
zITt	㡑
zIc	㍁
zIct	㈗
zIn	㡸
zInc	䉖
zIncst	㤔
zIngt	㐦
zInt	㌥
zL	㜵
zLn	㢖
zLnt	䄳
zN	㄂
zNt	㕦
zO	ひ
zOl	ㄨ
zOls	䘐
zOlst	㆔
zOlt	㠩
zOn	㕉
zOnst	㚖
zQk	䄅
zR	㍉
zUn	䕂
zUnt	㥅
za	㍷
zac	ㅲ
zacst	㍀
zag	㠲
zagt	㍵
zak	䕠
zan	㝶
ze	㉐
zeks	䅴
zen	㔱
zer	ㅁ
zi	い
zib	䕑
zik	㤱
zis	㖘
zist	㔖
zit	㕗
zo	げ
zom	䙩
zos	䑸
zu	䉤
zux	㡡
zuxs	䀄
zuxst	䂅
zuxt	ㄱ
zy	䉗
zys	㘓
