a	a
aaeh	a/e
ab	Ap
abbeissen	Ap/b1s/N
abend	a/bNt
aber	a/bR
abgebrochen	Ap/g@/brox/N
abgeholt	Ap/g@/golt
abgemacht	Ap/g@/mAxt
abgeschaut	Ap/g@/S3t
abgeschnitten	Ap/g@/SnI/tN
abgewaschen	Ap/g@/vA/SN
abholen	Ap/ho/lN
ablecken	A/plE/kN
abmachen	Ap/mAx/N
abputzen	Ap/pu/TN
abreissen	A/pr1s/N
abschneiden	Ap/Sn1/dN
abstreifen	Ap/Str1/fN
abwaschen	Ap/vA/SN
abwechselnd	Ap/vEk/zLnt
abwischen	Ap/vI/SN
abziehn	Ap/Ti/N
abzumachen	Ap/Tu/mAx/N
abzuwischen	Ap/Tu/vI/SN
acht	Axt
adebar	a/de/bar
adjektiven	Ad/jEk/ti/fN
aegypter	E/gyp/tR
aehnlich	en/lIc
aepfel	E/PL
aeusserung	2s/E/rUnc
affe	A/f@
affen	A/fN
afghanisches	Af/ga/nI/S@s
ahnung	a/nUnc
alex	A/lEx
alisia	A/li/zi/A
alle	A/l@
allein	A/l1n
alleine	A/l1/n@
allem	A/lM
allerdings	A/lR/dIngs
alles	A/l@s
allzu	Al/Tu
als	Als
also	Al/zo
alt	Alt
alte	Al/t@
alter	Al/tR
am	Am
ameise	a/m1/z@
ameisen	a/m1/zN
an	An
ander	An/dR
andere	An/dR/@
anderen	An/dR/N
anderes	An/dR/@s
andern	An/dRn
anders	An/dRs
andersrum	An/dRs/rum
andre	an/dr@
andrea	an/dre/A
andrere	An/drR/@
andres	An/dR/@s
anducken	An/dU/kN
anfassen	An/fAs/N
angeblich	An/ge/blIc
angefahren	An/g@/fa/rN
angefangen	An/g@/fAn/gN
angeguckt	An/g@/gUkt
angelaufen	An/g@/l3/fN
angenehm	An/g@/nem
angeschaut	An/g@/S3t
angezogen	An/g@/To/gN
angst	Ancst
angucken	An/gU/kN
anhalten	A/nhAl/tN
anhaltetest	A/nhAl/tEst
anhast	A/nhAst
anmachen	An/mAx/N
anmacht	An/mAxt
anmalen	An/ma/lN
anner	A/nR
anrufen	An/ru/fN
ans	Ans
anschauen	An/S3n
anschaun	An/S3n
ansonsten	An/zOn/stN
anspritzen	An/SprI/TN
anstaendig	An/StEn/dIc
anstrengend	An/StrEn/gNt
antworten	Ant/vOr/tN
anziehen	An/Ti/N
anziehn	An/Ti/N
anziehsachen	An/Ti/zAx/N
anzug	An/Tuc
apfel	A/PL
apparat	A/pA/rAt
april	A/prIl
arm	Arm
arme	Ar/m@
armer	Ar/mR
armreif	Arm/r1f
art	Art
attackieren	A/tA/ki/rN
auch	3x
auf	3f
aufessen	3/fEs/N
aufforderung	3/for/de/rUnc
auffressen	3f/frEs/N
aufgeben	3f/ge/bN
aufgefressen	3f/g@/frEs/N
aufgegessen	3f/g@/gEs/N
aufgenommen	3f/g@/nO/mN
aufgewacht	3f/g@/vAxt
aufheben	3f/he/bN
aufhören	3f/hq/rN
aufmachen	3f/mAx/N
aufmüpfig	3f/mY/PIc
aufmüpfiger	3f/mY/PI/gR
aufn	3/fN
aufnahme	3f/na/m@
aufnahmen	3f/na/mN
aufnehmen	3f/ne/mN
aufpassen	3f/pAs/N
aufraemen	3/fr2/mN
aufraeum	3/fr2m
aufraeumen	3/fr2/mN
aufs	3fs
aufschlagen	3f/Sla/gN
aufstehen	3f/Ste/N
aufstehn	3f/Ste/N
aufsteigen	3f/st1/gN
aufzufordern	3f/Tu/fOr/dRn
auge	3/g@
augen	3/gN
aus	3s
ausbeute	3s/b2/t@
ausdrücke	3s/dry/k@
auseinander	3s/1/nAn/dR
auseinandermachen	3s/1/nAn/dR/mAx/N
ausgesucht	3s/g@/zuxt
ausgetrunken	3s/g@/trUn/kN
ausgezogen	3s/g@/To/gN
auskratzen	3s/krA/TN
ausmachen	3s/mAx/N
ausrangieren	3s/ran/gi/rN
ausser	3s/R
ausserdem	3s/R/dem
aussortieren	3ss/Or/ti/rN
ausziehen	3s/Ti/N
ausziehn	3s/Tin
auto	3/to
autos	3/tos
auziehen	3/Ti/N
ayche	1/S@
aysche	1/S@
ayse	1/S@
ayshe	1/S@
ba	ba
babies	be/bis
baby	be/bi
babyaffen	be/bi/A/fN
babybuch	be/bi/bux
babynilpferd	be/bi/nIl/Pert
babypony	be/bi/po/ni
bach	bax
badbuch	bat/bux
badefest	ba/d@/fEst
badehose	ba/d@/ho/z@
badehosen	ba/d@/ho/zN
badewanne	ba/d@/va/n@
badezimmer	ba/d@/TI/mR
baecker	bE/kR
baelle	bE/l@
baer	be/R
baerchen	ber/cN
baeren	be/rN
baern	be/rN
baeume	b2/m@
baeumen	b2/mN
baeürin	b2/rIn
bahnhof	ba/nhof
bald	bAlt
balkon	bAl/kon
ball	bAl
bamm	bAm
banane	bA/na/n@
bananen	bA/na/nN
band	bAnt
bank	bAnk
bastian	bAst/jN
bau	b3
bauch	b3x
bauchweh	b3x/ve
baue	b3/@
bauen	b3/N
bauer	b3r
bauernhaeuser	b3/rN/h2s/R
bauernhaus	b3/rN/h3s
bauernhof	b3r/nhof
bauklötze	b3/klq/T@
bauklötzern	b3/klq/TRn
baum	b3m
baumt	b3mt
baustelle	b3/stE/l@
baut	b3t
becher	bE/ChR
becken	bE/kN
befreie	b@/fr1/@
begeisterung	b@/g1/stR/Unc
beginnt	b@/gInt
begleitet	b@/gl1/tEt
bei	b1
beide	b1/d@
beiden	b1/dN
beim	b1m
bein	b1n
beinah	b1/na
beine	b1/n@
beinen	b1/nN
beispiel	b1/Spil
beiss	b1s
beissen	b1s/N
beisst	b1st
bekommen	b@/kO/mN
bellt	bElt
benennungen	b@/nE/nUn/gN
berg	b@rc
berge	b@r/g@
beschaetigen	b@/SE/tI/gN
beschmiert	b@/Smirt
beschreibend	b@/Sr1/bEnt
besonderes	b@/zOn/dR/@s
besonders	b@/zOn/dRs
besser	bEs/R
bessrer	bEs/rR
bestehst	bE/Stest
besten	bE/stN
bestens	bE/stens
bestimmt	bE/stImt
bestimmte	bE/stIm/t@
besuch	b@/zux
bett	bEt
bettchen	bEt/cN
bettwaesche	bEt/vE/S@
bettzeug	bE/T2c
beute	b2/t@
beutel	b2/tL
bezogen	b@/To/gN
biba	bI/bA
bienchen	bin/cN
biene	bi/n@
bienen	bi/nN
bild	bIlt
bilder	bIl/dR
bilderbuch	bIl/dR/bux
bilderbücher	bIl/dR/by/ChR
bildern	bIl/dRn
bildet	bIl/dEt
bimmelbaehnchen	bI/mL/ben/cN
bimmelbahn	bI/mL/ban
bimmelt	bI/mElt
bin	bIn
bindet	bIn/dEt
bis	bIs
bischen	bIs/cN
bisschen	bIs/cN
bissel	bIs/L
bissschen	bIs/SN
bist	bIst
bitte	bI/t@
bitteschön	bI/t@/Sqn
blaeschen	bles/cN
blaettchen	blEt/cN
blaetter	blE/tR
blaettern	blE/tRn
blatt	blAt
blau	bl3
blaue	bl3/@
blauen	bl3/N
bleib	bl1p
bleiben	bl1/bN
bloss	blOs
blume	blu/m@
blumen	blu/mN
blumenwiesen	blu/mN/vi/zN
blut	blut
blöd	blqt
blöder	blq/dR
blümchen	blym/cN
boden	bo/dN
bohnen	bo/nN
bord	bOrt
brauch	br3x
brauchen	br3x/N
brauchst	br3xst
braucht	br3xt
braun	br3n
braune	br3/n@
brav	brAf
bremst	brEmst
brennen	brE/nN
brettchen	brEt/cN
brief	brif
briefe	bri/f@
brille	brI/l@
bring	brInc
bringen	brIn/gN
bringt	brIngt
brot	brot
brote	bro/t@
bröckchen	brQk/cN
bröselei	brq/zL/1
brötchen	brqt/cN
brücke	brY/k@
buch	bux
bumm	bUm
bummelt	bU/mLt
bums	bums
bunte	bUn/t@
bus	bUs
butter	bU/tR
bücher	by/cR
büchlein	byc/l1n
bügeln	by/gLn
bügelt	by/gLt
bürste	bYr/st@
carola	CA/ro/lA
caroline	CA/ro/li/n@
carolines	CA/ro/li/n@s
chaos	ka/Os
charakter	kA/rak/tR
charlie	Sar/li
charlies	Sar/lis
charlotte	SAr/lO/t@
charlottte	SAr/lO/t@
charly	Sar/li/e
chic	ChIC
chiemsee	Chim/ze
chinesisches	ci/ne/zI/S@s
claudia	kl3/di/a
clown	kl3n
creme	krEm
da	dA
dabei	dA/b1
dach	dAx
dacht	dAxt
dachte	dAx/t@
dacke	dA/k@
dadran	dA/drAn
dadrauf	dA/dr3f
dahin	dA/hIn
dahinten	dA/hIn/tN
damals	dA/mAls
dame	da/m@
damit	dA/mIt
danach	dA/nAx
danke	dAn/k@
dankeschön	dAn/k@/Sqn
dann	dAn
darauf	dA/r3f
daraufklettern	dA/r3f/klE/tRn
daraus	dA/r3s
darf	dArf
darfst	dArfst
das	dAs
dasn	dAs/N
dass	dAs
dasselbe	dAs/El/b@
dasteht	dA/Stet
daumen	d3/mN
davon	dA/fOn
davorne	dA/for/n@
dawas	dA/vAs
dazu	dA/Tu
dazugelernt	dA/Tu/g@/lernt
dazwischen	dA/TvI/SN
decke	dE/k@
deckel	dE/kL
deim	d1m
dein	d1n
deine	d1/n@
deinem	d1/nM
deinen	d1/nN
deiner	d1/nR
deines	d1/n@s
deinm	d1/nM
deins	d1ns
dem	dem
den	den
denen	de/nN
denke	dEn/k@
denken	dEn/kN
denkst	dEnkst
denkt	dEnkt
denn	dEn
der	der
derweil	der/v1l
desselben	dEs/El/bN
deswegen	dEs/ve/gN
di	di
dibbel	dI/bL
dich	dIc
dick	dIk
dicke	dI/k@
dicken	dI/kN
dicker	dI/kR
dickes	dI/k@s
dickmadame	dIk/ma/da/m@
die	di
diener	di/nR
dies	dis
diese	di/z@
diesen	di/zN
dieser	dis/R
dieses	di/z@s
diesmal	dis/mAl
dietzi	di/Ti
diezi	di/Ti
diezie	di/Ti
diezies	di/Tis
ding	dInc
dinge	dIn/g@
dinger	dIn/gR
dir	dir
direkt	di/rEkt
direkte	di/rEk/t@
dirs	dirs
doch	dOx
dokter	dOk/tOr
doktor	dOk/tOr
dokumentiert	dO/ku/mEn/tirt
doll	dOl
dolle	dO/l@
dollen	dO/lN
dolles	dO/l@s
donner	dO/nR
doof	dof
dran	drAn
drauf	dr3f
draufdrücken	dr3f/drY/kN
draufgeklebt	dr3f/g@/klept
draufgemacht	dr3f/g@/mAxt
draufgemalt	dr3f/g@/malt
draufgeschreiben	dr3f/g@/Sr1/bN
draufgesteckt	dr3f/g@/StEkt
draufgetan	dr3f/g@/tan
draufmachen	dr3f/mAx/N
draufmalen	dr3f/ma/lN
draufstecken	dr3f/StE/kN
draufsteigen	dr3f/St1/gN
draufstellen	dr3f/StE/lN
drauftreten	dr3f/tre/tN
drauftun	dr3f/tun
draussen	dr3s/N
dreck	drEk
dreckeckig	drE/kIc
dreckfingern	drEk/fIn/gRn
dreckhaenden	drEk/hEn/dN
dreckig	drE/kIc
drehen	dre/N
dreht	dret
drei	dr1
dreimal	dr1/mAl
dreirad	dr1/rAt
drin	drIn
drinnen	drI/nN
drunter	drUn/tR
drüben	dry/bN
drüber	dry/bR
drück	dryk
drücken	dry/kN
dschidschi	JI/JI
du	du
dumm	dUm
dumme	dU/m@
dummes	dU/m@s
dunkel	dUn/kL
durch	dUrc
durchbrechen	dUrc/brE/cN
durcheinander	dUr/c1/nAn/dR
durchgehen	dUrc/ge/N
durchkrabbeln	dUrc/krA/bLn
durchschneiden	dUrc/Sn1/dN
dusche	du/S@
duschen	du/SN
dünn	dYn
dürfen	dYr/fN
eben	e/bN
ecke	E/k@
eckig	E/kIc
eckliges	E/klI/g@s
edel	e/dL
eh	e
eher	e/R
ehrlich	er/lIc
ei	1
eichhörnchen	1c/hQrn/cN
eier	1/R
eierlöffel	1/R/lQ/fL
eiern	1/Rn
eigenes	1/gN/@s
eigenschaften	1/gN/Saf/tN
eigentlich	1/gNt/lIc
eimer	1/mR
ein	1n
eindeutig	1n/d2/tIc
eindruck	1n/druk
eine	1/n@
einem	1/nM
einen	1/nN
einer	1/nR
einfach	1n/fAx
eingang	1n/ganc
eingerissen	1n/g@/rIs/N
eingesperrt	1n/g@/Spert
eingewickelt	1n/g@/vI/kLt
eingezwickt	1n/g@/TvIkt
einige	1/nI/g@
einkaufen	1n/k3/fN
einkaufswagen	1n/k3fs/va/gN
einmal	1n/mAl
einordnen	1/nOrd/nN
einordnung	1/nord/nUnc
eins	1ns
einsatz	1n/zAT
einschmiern	1n/Smi/rN
einstecken	1n/StE/kN
einsteigen	1n/St1/gN
einzelne	1n/TEl/n@
einzelnen	1n/TEl/nN
einzige	1n/TI/g@
eis	1s
eisbaer	1s/ba/R
eisenbahn	1/zen/ban
eisenbahnen	1/zen/ba/nN
eismann	1s/mAn
eisschrank	1s/SrAnk
eklige	e/klI/g@
elefant	E/lE/fAnt
elefanten	E/lE/fAn/tN
elfant	E/lE/fAnt
ende	En/d@
endlich	Ent/lIc
eng	Enc
engeln	En/gLn
entchen	Ent/cN
ente	En/t@
enten	En/tN
entsprechend	Ent/SprE/cNt
entweder	Ent/ve/dR
entzündet	En/TYn/d@t
er	er
erdbeere	Erd/be/r@
erdbeeren	Erd/be/rN
erdbeern	Erd/be/rN
erde	Er/d@
ereignis	E/r1g/nIs
erfolg	Er/folc
erhebe	er/he/b@
erika	E/rI/kA
erinner	e/rI/nR
erinnerst	e/rI/nRst
erinnert	e/rI/nRt
erkennt	er/kEnt
erklaert	er/klert
erschliessen	er/Slis/N
erschrack	er/SrAk
erst	erst
ersten	er/stN
erstes	er/st@s
erstmal	erst/mAl
erworben	er/vOr/bN
erzaehl	er/Tel
erzaehle	er/Te/l@
erzaehlen	er/Te/lN
erzaehln	er/Te/lN
erzaehls	er/Tels
erzaehlst	er/Telst
erzaehlt	er/Telt
es	Es
esel	e/zL
eseln	e/zLn
ess	Es
essen	Es/N
etwas	Et/vAs
eu	2
euch	2c
eule	2/l@
extra	Eks/trA
fabi	fa/bi
faden	fa/dN
faehrt	fert
faellst	fElst
faellt	fElt
faengt	fEngt
fahren	fa/rN
fahrn	fa/rN
fahrzeuge	far/T2/g@
fall	fAl
falsche	fAl/S@
familie	fA/mil/j@
famille	fA/mil/j@
fand	fAnt
fang	fAnc
fangen	fAn/gN
farbe	far/b@
farben	far/bN
farbwort	farb/vOrt
fasan	fa/zan
fassen	fAs/N
fast	fAst
fehlen	fe/lN
fehlt	felt
fehltn	fel/tN
feige	f1/g@
feigling	f1/glInc
feld	fElt
fell	fEl
fenster	fEn/stR
ferkel	fer/kL
fertig	fer/tIc
fertigmachen	fer/tIc/mAx/N
fest	fEst
festgehalten	fEst/g@/hAl/tN
festgeklebt	fEst/g@/klept
festgemacht	fEst/g@/mAxt
festhalten	fEst/hAl/tN
fettfingern	fEt/fIn/gRn
fettig	fE/tIc
feuer	f2/R
feuerwehrauto	f2/R/ve/r3/to
finde	fIn/d@
finden	fIn/dN
findest	fIn/dEst
finger	fIn/gR
fingerchen	fIn/gR/cN
fingern	fIn/gRn
fingernaegel	fIn/gR/ne/gL
fisch	fIS
fische	fI/S@
fischen	fI/SN
flaeschchen	flES/cN
flaeschchench	flES/cN
flaeschen	flE/SN
flasche	flA/S@
flaschen	flA/SN
flecken	flE/kN
fleigt	fligt
fleisch	fl1S
fliege	fli/g@
fliegen	fli/gN
fliegt	fligt
flugzeug	flux/T2c
flugzeuge	flux/T2/g@
fluss	flus
fortsetzung	fOrt/zE/TUnc
fotoapparat	fo/to/a/pa/rat
frage	fra/g@
frageintonation	fra/g1n/to/na/Ti/on
fragt	frAxt
frau	fr3
frauen	fr3/N
frech	frEc
frechdachs	frEc/daxs
freche	frE/c@
frechen	frE/cN
frecher	frE/cR
freches	frE/c@s
fresse	frEs/@
fressen	frEs/N
freunde	fr2n/d@
freust	fr2st
freut	fr2t
frisch	frIS
frische	frI/S@
frischen	frI/SN
frisches	frI/S@s
frisst	frIst
fritz	frIT
frosch	frOS
frösche	frQ/S@
früchte	frYc/t@
früh	fry
frühstück	fry/StYk
frühstücken	fry/stY/kN
früstücken	fry/sty/kN
fuchs	fuks
fuhr	fur
fuhrknecht	fur/knEct
furchtbar	fUrct/bar
fuss	fus
fühlern	fy/lRn
führt	fyrt
fünf	fYnf
fünfmal	fYnf/mal
für	fyr
fürn	fyrn
fürne	fyr/n@
fürs	fyrs
füsse	fys/@
füttert	fY/tErt
gabel	ga/bL
gaby	ga/bi
gaehnen	ge/nN
gaehnt	gent
gaense	gEn/z@
gan	gan
gans	gAns
ganz	gAnT
ganze	gAn/T@
ganzen	gAn/TN
ganzer	gAn/TR
ganzes	gAn/T@s
gar	gar
gas	gas
gearde	g@/rA/d@
geb	g@p
gebaut	g@/b3t
geben	ge/bN
gebissen	g@/bIs/N
geblaettert	g@/blE/tErt
geblieben	g@/bli/bN
gebracht	g@/brAxt
gebraucht	g@/br3xt
geburtstag	g@/burt/stAc
geburtstagsgeschenke	g@/burt/stAgs/g@/SEn/k@
geburtstagskuchen	g@/burt/stAgs/kux/N
gedacht	g@/dAxt
gedanken	g@/dAn/kN
gefaehrlich	g@/fer/lIc
gefahren	g@/fa/rN
gefahrn	g@/fa/rN
gefallen	g@/fA/lN
gefalln	g@/fA/lN
gefang	g@/fAnc
gefangen	g@/fAn/gN
geflogen	g@/flo/gN
gefragt	g@/frAgt
gefressen	g@/frEs/N
gefunden	g@/fUn/dN
gefüllt	g@/fYlt
gegaehnt	g@/gent
gegangen	g@/gAn/gN
gegeben	g@/ge/bN
gegen	ge/gN
gegend	ge/gEnt
gegenstaende	ge/gEn/stEn/d@
gegessen	g@/gEs/N
geglückt	g@/glYkt
geguckt	g@/gUkt
geh	ge
gehabt	g@/hApt
gehaemmert	g@/hE/mErt
gehen	ge/N
gehn	ge/N
geholfen	g@/hOl/fN
geholt	g@/holt
gehst	gest
geht	get
gehts	gets
gehörn	g@/hqrn
gehört	g@/hqrt
geier	g1/R
gekaemmt	g@/kEmt
gekauft	g@/k3ft
gekitzelt	g@/kI/TLt
geklappt	g@/klApt
geklebt	g@/klept
geklettert	g@/klE/tErt
geklopft	g@/klOPt
geknickelt	g@/knI/kLt
gekomm	g@/kOm
gekommen	g@/kO/mN
gekrabbelt	g@/krA/bLt
gekriegt	g@/krigt
gelassen	g@/lAs/N
gelaufen	g@/l3/fN
gelb	gElp
gelbe	gEl/b@
gelben	gEl/bN
geld	gElt
gelder	gEl/dR
geleckt	g@/lEkt
geleiert	g@/l1/Rt
gelesen	gE/le/zN
gell	gEl
gelsen	gEl/zN
gemacht	g@/mAxt
gemalt	g@/malt
gemolken	g@/mOl/kN
gemütlich	g@/myt/lIc
gemütlicher	g@/myt/lI/cR
genau	g@/n3
genauso	g@/n3/zo
genomm	g@/nOm
genommen	g@/nO/mN
genug	g@/nuc
genügt	g@/nygt
gepackt	g@/pAkt
geparkt	g@/pArkt
gepimpt	g@/pImpt
gepustet	g@/pu/st@t
geputzt	g@/pUTt
gerade	g@/rA/d@
geraet	g@/ret
gering	g@/rInc
gerissen	g@/rIs/N
geritten	g@/rI/tN
gern	gern
gerne	ger/n@
gerutscht	g@/rUCt
gesagt	g@/zAgt
gesaugt	g@/z3gt
geschaftig	g@/SAf/tIc
geschaukelt	g@/S3/kElt
geschenkt	g@/SEnkt
geschichte	g@/SIc/t@
geschimpft	g@/SImPt
geschlafen	g@/Sla/fN
geschmeide	g@/Sm1/d@
geschmekt	g@/SmEkt
geschnitten	g@/SnI/tN
geschrieben	g@/Sri/bN
geschupst	g@/SUpst
geschwomm	g@/SvOm
geschwommen	g@/SvO/mN
gesehen	g@/ze/N
gesehn	g@/ze/N
gesessen	g@/zEs/N
gesicht	g@/zIct
gesichter	g@/zIc/tR
gespielt	g@/Spilt
gespritzt	g@/SprITt
gesprungen	g@/SprUn/gN
gessen	g@/gEs/N
gesteckt	g@/StEkt
gestern	gE/stErn
gestiegen	g@/Sti/gN
gestochen	g@/StOx/N
gestreichelt	g@/Str1/cElt
gestritten	g@/StrI/tN
gesucht	g@/zuxt
gesund	g@/zUnt
gesungen	g@/zUn/gN
getan	g@/tan
getaucht	g@/t3xt
getrunken	g@/trUn/kN
geturnt	g@/turnt
gewalt	g@/vAlt
gewaltigen	g@/vAl/tI/gN
gewaschen	g@/vA/SN
geweih	g@/v1
geweint	g@/v1nt
gewesen	g@/ve/zN
geworden	g@/vOr/dN
gewunken	g@/vUn/kN
gewütet	g@/vy/t@t
gezankt	g@/TAnkt
gezeichnet	g@/T1c/n@t
gezeigt	g@/T1gt
gezogen	g@/To/gN
gib	gIp
gibs	gIps
gibst	gIpst
gibt	gIpt
gibts	gIpts
ging	gInc
gingen	gIn/gN
giraffe	JI/ra/f@
glaeser	gles/R
glas	glas
glatt	glAt
glaub	gl3p
glaube	gl3/b@
gleich	gl1c
gleiche	gl1/c@
glocke	glO/k@
glöckchen	glQk/cN
glück	glYk
grad	grAt
grade	g@/rA/d@
gras	gras
grashüpfer	gras/hY/PR
griff	grIf
grob	grop
gross	gros
grosse	gros/@
grosseltern	gros/El/tRn
grossem	gros/M
grossen	gros/N
grosser	gros/R
grosses	gros/@s
grossmama	gros/mA/mA
grossmamma	gros/mA/mA
grossmutter	gros/mU/tR
grossvater	gros/fa/tR
grossvaters	gros/fa/tRs
gruppenbild	gru/pN/bIlt
grösser	grqs/R
grösstes	grq/st@s
grün	gryn
grüne	gry/n@
grünen	gry/nN
grüsse	grys/@
guck	gUk
gucken	gU/kN
guckst	gUkst
guckt	gUkt
gummi	gU/mi
gummibaerchen	gU/mi/ber/cN
gurke	gur/k@
gut	gut
gute	gu/t@
guten	gu/tN
gutgegangen	gut/g@/gAn/gN
ha	hA
haare	ha/r@
haaren	ha/rN
haarkamm	har/kAm
haarspange	har/SpAn/g@
hab	hAp
habe	hA/b@
haben	hA/bN
habn	hA/bN
habs	hAps
habt	hApt
haelt	hElt
haendchen	hEnd/cN
haende	hEn/d@
haenden	hEn/dN
haeng	hEnc
haengst	hEnkst
haengt	hEnkt
haett	hEt
haette	hE/t@
haettst	hEtst
haeufiger	h2/fI/gR
haeuschen	h2s/cN
hahn	han
hais	h1s
halbe	hAl/b@
halli	hA/lo
hallo	hA/lo
hals	hAls
halsbrecherisch	hAls/brE/cR/IS
halt	hAlt
halten	hAl/tN
hammer	hA/mR
hampelmann	hAm/pL/mAn
hams	hAms
hamstern	hAm/stRn
hand	hAnt
handlungen	hAnd/lUn/gN
handtuch	hAn/tux
hans	hAns
hantiert	hAn/tirt
happ	hAp
haps	hAps
hart	hArt
harten	hAr/tN
hase	ha/z@
hasen	ha/zN
hassan	has/an
hast	hAst
hat	hAt
hatn	hA/tN
hats	hAts
hatte	hA/t@
hatten	hA/tN
hattest	hA/tEst
haus	h3s
hause	h3/z@
haut	h3t
he	h@
heben	he/bN
heft	hEft
heia	h1/A
heiabeia	h1/a/b1/a
heidelberg	h1/dL/berc
heidrun	h1/drun
heile	h1/l@
heinrich	h1n/rIc
heis	h1s
heiss	h1s
heissen	h1s/N
heisst	h1st
heiterm	h1/tRm
heizung	h1/TUnc
hel	hEl
helfen	hEl/fN
hemd	hEmt
hemden	hEm/dN
henri	hEn/ri
henrie	hEn/ri
henriettchen	hEn/ri/Et/cN
her	her
herd	hert
hergerichtet	her/g@/rIc/t@t
herniette	hEn/ri/E/t@
herrn	hern
herum	h@/rum
herumgespenstert	h@/rum/g@s/pEn/stRt
heu	h2
heuer	h2/R
heuhupfer	h2/hY/PR
heuschrecke	h2/SrE/k@
heut	h2/t@
heute	h2/t@
hey	he/i
hier	hir
hierrein	hir/r1n
hilf	hIlf
hilfe	hIl/f@
hilfst	hIlfst
hilft	hIlft
himmel	hI/mL
himpelchen	hIm/pL/cN
hin	hIn
hinfallen	hIn/fA/lN
hingefallen	hIn/g@/fA/lN
hingefalln	hIn/g@/fAln
hingeführt	hIn/g@/fyrt
hingekriegt	hIn/g@/krict
hingekullert	hIn/g@/kU/lRt
hingelegt	hIn/g@/legt
hingeschmiert	hIn/g@/Smirt
hingeschrieben	hIn/g@/Sri/bN
hingestellt	hIn/g@/StElt
hingetan	hIn/g@/tan
hinlegen	hIn/le/gN
hinnelegt	hIn/g@/legt
hinsaust	hIn/z3st
hinsetzen	hIn/zE/TN
hinstellen	hIn/StE/lN
hinten	hIn/tN
hinter	hIn/tR
hintergrund	hIn/tR/grUnt
hinterher	hIn/tR/her
hinterm	hIn/te/rM
hintun	hIn/tun
hirsche	hIr/S@
hoch	hOx
hochgeklettert	hOx/g@/kl3/t3rt
hochgezogen	hOx/g@/To/gN
hochklettern	hOx/kl3/tRn
hof	hof
hoffentlich	hO/f3nt/lIc
hoffnung	hOf/nUnc
hoher	ho/R
hol	hol
holen	ho/lN
holn	ho/lN
holst	holst
holt	holt
holz	hOlT
holzstab	hOlT/Stap
holzwurm	hOl/Tvurm
honig	ho/nIc
honigbrot	ho/nIg/brot
hoppla	hO/plA
horst	hOrst
hose	ho/z@
hu	hu
hubschrauber	hup/Sr3/bR
huhn	hun
hummel	hU/mL
hund	hUnt
hunde	hUn/d@
hundebaby	hUn/de/be/bi
hunger	hUn/gR
hupfen	hU/PN
hupfst	hUPst
huppala	ho/pa/la
hut	hut
höhe	hq/@
höhle	hq/l@
hör	hqr
höre	hq/r@
hören	hq/rN
hörn	hq/rN
hörst	hqrst
hört	hqrt
hühner	hy/nR
hühnern	hy/nRn
hüllt	hYlt
hüpf	hYP
hüpfen	hY/PN
hüpft	hYPt
ich	Ic
idee	i/de
igel	i/gL
ihm	im
ihn	in
ihnen	i/nN
ihr	ir
ihre	i/r@
ihrem	i/rM
ihren	i/rN
ihrer	i/rR
im	Im
imitiert	I/mI/tirt
immer	I/mR
immerzu	I/mR/Tu
in	In
indianermaedchen	in/di/A/nR/med/cN
ineinander	I/n1/nAn/dR
innen	I/nN
inner	I/nR
ins	Ins
interesant	In/tE/rEs/Ant
interessant	In/tE/rEs/Ant
interssantes	In/tE/rEs/An/t@s
inzwischen	In/TvI/SN
irdenetwas	Ir/gEn/tEt/vAs
irgend	Ir/gEnt
irgendetwas	Ir/gEn/tEt/vAs
irgendwas	Ir/gEnd/vAs
irgendwelche	Ir/gEnt/vEl/c@
irgendwelchen	Ir/gEnt/vEl/cN
irgendwie	Ir/gEnt/vi
irgendwo	Ir/gEnt/vo
irre	I/r@
irres	I/r@s
irrsinnig	Ir/zI/nIc
irrsinniger	Ir/zI/nI/gR
is	Ist
iss	Is
isses	Is/@s
isst	Ist
ist	Ist
italien	i/ta/li/N
ja	jA
jaa	jA
jacke	ja/k@
jaeger	je/gR
jahr	jar
jahre	ja/r@
jang	jAnc
januar	jA/nu/ar
jatzt	jATt
jawoll	jA/vOl
jedenfalls	je/dN/fals
jeder	je/dR
jedes	je/d@s
jemand	je/mAnt
jetz	jETt
jetzt	jETt
jeweils	je/v1ls
jezt	jETt
jiangning	jAng/nInc
jiau	jI/3
joghurt	jo/gurt
johannesbeeren	jo/hA/nQs/be/rN
jose	jo/z@
josephine	jo/z@/fi/n@
juli	ju/lI
jumbo	jUm/bo
junge	jUn/g@
jungen	jUn/gN
junger	jUn/gR
juri	ju/ri
jury	Ju/ri
kaefer	ke/fR
kaelbchen	kElp/cN
kaese	ke/z@
kaesebrot	ke/z@/brot
kaestchen	kEst/cN
kaetzchen	kET/cN
kaffe	kA/fe
kaffee	kA/fe
kaffekanne	kA/fe/kA/n@
kalt	kAlt
kalte	kAl/t@
kam	kam
kamel	kA/mL
kamele	kA/mE/l@
kamelen	kA/mE/lN
kamera	kA/mE/rA
kamm	kAm
kann	kAn
kanne	kA/n@
kanns	kAns
kannst	kAnst
kapiert	ka/pirt
kaput	kA/pUt
kaputt	kA/pUt
kaputtes	kA/pU/t@s
kaputtgegangen	kA/pUt/g@/gAn/gN
kaputtgehen	kA/pUt/ge/N
karins	ka/rins
karte	kAr/t@
kartoffel	kAr/tO/fL
kartoffeln	kAr/tO/fLn
kartoffelsaecke	kAr/tO/fL/zE/k@
karton	kAr/ton
kassette	kAs/E/t@
kassettenhülle	kAs/E/te/nhy/l@
katastrophe	kA/tAs/tro/f@
katze	kA/T@
katzen	kA/TN
kauen	k3/N
kauf	k3f
kaufen	k3/fN
kauft	k3ft
kausalen	k3/za/lN
kein	k1n
keine	k1/n@
keinen	k1/nN
keiner	k1/nR
keks	keks
kennst	kEnst
kennt	kEnt
kerne	ker/n@
kerze	ker/T@
kerzen	ker/TN
kette	kE/t@
kichererbse	kI/cR/erb/z@
kikereki	kI/kR/e/kI
kikiriki	ki/ki/ri/ki
kind	kInt
kinder	kIn/dR
kirchturm	kirc/tUrm
kirschen	kIr/SN
kissen	kIs/N
kitzbühl	kIT/byl
kitzelt	kI/TElt
klappert	klA/pRt
klar	klAr
klatsche	klA/C@
klaus	kl3s
kleben	kle/bN
klebrig	kle/brIc
klebt	klept
klecker	klE/kR
kleckert	klE/kRt
klee	kle
kleid	kl1t
klein	kl1n
kleine	kl1/n@
kleinen	kl1/nN
kleiner	kl1/nR
kleines	kl1/n@s
kleingeld	kl1n/gElt
kleinnes	kl1/n@s
kleinschneiden	kl1n/Sn1/dN
klemmt	klEmt
klettermax	klE/tR/mAks
klettern	klE/tRn
klettert	klE/tRt
kletterturm	klE/tR/tUrm
klötze	klQ/T@
knacks	knAks
knallt	knAlt
knappen	knA/pN
knibbelklein	knI/bL/kl1n
knibbelt	knI/bLt
knie	kni
knochen	knOx/N
knopf	knOP
knöpfe	knQ/P@
knöpfen	knQ/PN
knüpfen	knY/PN
koffer	kO/fR
kombiniert	kOm/bI/nirt
komisch	ko/mIS
komischen	ko/mI/SN
komm	kOm
komme	kO/m@
kommen	kO/mN
kommse	kOm/z@
kommst	kOmst
kommt	kOmt
kommunikation	ko/mu/nI/ka/Ti/on
konjugiert	kOn/ju/girt
konnte	kOn/t@
konntest	kOn/t@st
kontrollieren	kOn/trO/li/rN
kontrolliern	kOn/trO/li/rN
konzept	kOn/TEpt
kopf	kOP
kopfkissen	kOP/kIs/N
kopfverband	kOP/fer/bant
korb	kOrp
kra	kra
krabbel	krA/bL
krabbeln	krA/bLn
krachmacherei	krAx/mAx/e/r1
krachst	krAxst
krakeleien	kra/kL/1/N
krakelt	kra/kLt
krank	krAnk
krankenhaus	krAn/kN/h3s
kreiden	kr1/dN
krieg	kric
kriegen	kri/gN
kriegst	kricst
kriegt	krict
kroko	krO/ko
krokodil	krO/ko/dil
kuchen	kux/N
kugeln	ku/gLn
kuh	ku
kuhstall	ku/stAl
kurz	kUrT
kuscheln	kU/SLn
kutsche	kUt/S@
könige	kq/nI/g@
können	kQ/nN
könnn	kQ/nN
könnt	kQnt
könnte	kQn/t@
körner	kQr/nR
körper	kQr/pR
körperlich	kQr/pR/lIc
körperteile	kQr/pR/t1/l@
küche	ky/c@
kücken	ky/kN
kühe	ky/@
kühen	ky/N
küsschen	kYs/cN
lachen	lAx/N
lachst	lAxst
lacht	lAxt
laden	la/dN
ladungen	la/dUn/gN
laedt	let
laengs	lEncs
laengst	lEncst
laengsten	lEnc/stN
laesst	lEst
laetzchen	lET/cN
laeufst	l2fst
laeuft	l2ft
lampe	lAm/p@
lang	lAnc
lange	lAn/g@
langen	lAn/gN
langer	lAn/gR
langsam	lAng/zAm
lappen	lA/pN
lass	lAs
lassen	lAs/N
lastauto	lA/st3/to
laster	lA/stR
laterne	lA/ter/n@
laufen	l3/fN
laut	l3t
lauter	l3/tR
lebte	lep/t@
leck	lEk
lecken	lE/kN
lecker	lE/kR
leckt	lEkt
leer	le/R
leg	lec
legen	le/gN
legs	lecs
legst	lecst
legt	lect
leguan	le/gu/an
leiber	l1/bR
leicht	l1ct
leider	l1/dR
leise	l1/z@
leiter	l1/tR
leitern	l1/tRn
lena	le/nA
leopard	le/o/pArt
lesen	le/zN
letzte	lET/t@
letzten	lET/tN
letztes	lET/t@s
leut	l2t
leute	l2/t@
licht	lIct
lichtlein	lIct/l1n
lieb	lip
lieber	li/bR
liebes	li/b@s
lieblingsbuch	li/blings/bux
lieblingsfarbe	li/blings/far/b@
lied	lit
lieder	li/dR
liegen	li/gN
liegt	ligt
liese	li/z@
liest	list
lila	li/la
lina	li/na
loch	lox
lokführer	lOk/fy/rR
los	los
losgefahren	los/g@/fa/rN
lotsen	lO/TN
lotte	lO/t@
luft	lUft
luftballon	lUft/bA/lOn
lustig	lU/stIc
lustige	lU/stI/g@
lustigen	lU/stI/gN
lustiger	lU/stI/gR
lustiges	lU/stI/g@s
löffel	lQ/fL
löffeln	lQ/fLn
löschen	lq/SN
löwe	lq/v@
löwen	lq/vN
löwenmutter	lq/vN/mU/tR
löwin	lq/vIn
mach	mAx
mache	mAx/@
machen	mAx/N
machens	mAx/Ns
machs	mAxs
machst	mAxst
machstn	mAx/stN
macht	mAxt
machte	mAx/t@
machtn	mAx/tN
machts	mAxts
maedchen	med/cN
maeh	me
maehne	me/n@
maenner	mE/nR
maennlein	mEn/l1n
maeuschen	m2s/cN
maeuse	m2/z@
maeuselchen	m2/zL/cN
maeusen	m2/zN
mag	mAc
magst	mAcst
mahl	mal
maiburg	m1/bUrc
mal	mAl
malblock	mal/blOk
malen	ma/lN
maler	ma/lR
malkunst	mal/kUnst
maln	ma/lN
malst	malst
malstifte	mal/StIf/t@
malt	malt
mama	mA/mA
mami	mA/mi
mamis	mA/mis
mammi	mA/mi
mammis	A/a/mis
man	mAn
manches	mAn/c@s
manchmal	mAnc/mAl
manipuliert	mA/nI/pu/lirt
mann	mAn
mantel	mAn/tL
marabu	mA/rA/bu
marianne	mA/ri/A/n@
marie	mA/ri
marienkaefer	mA/ri/N/ke/fR
mark	mArk
markt	mArkt
markus	mAr/kus
markuss	mAr/kus
marmelade	mAr/m@/la/d@
maus	m3s
medizin	mE/dI/Tin
mehr	mer
meim	m1n
mein	m1n
meine	m1/n@
meinem	m1/nM
meinen	m1/nN
meiner	m1/nR
meins	m1ns
meinst	m1nst
meinste	m1n/st@
meint	m1nt
meistems	m1/stNs
meister	m1/stR
melkt	mElkt
menge	mEn/g@
mensch	mEnS
menschen	mEn/SN
meppo	mE/po
merken	mer/kN
merkst	merkst
messer	mEs/R
metzger	mET/gR
miau	mI/3
mich	mIc
michi	mi/ci
milch	mIlc
mineralwasserflasche	mI/nE/ral/vAs/R/flA/S@
mir	mir
mist	mIst
mit	mIt
mitgebracht	mIt/g@/brAxt
mitgefahren	mIt/g@/fa/rN
mitgefahrn	mIt/g@/fa/rN
mitgenomm	mIt/g@/nO/mN
mitgewesen	mIt/g@/ve/zN
mitkomm	mIt/kO/mN
mitkommen	mIt/kO/mN
mitm	mItm
mitnehm	mIt/nem
mitnehmen	mIt/ne/mN
mitspielen	mIt/Spi/lN
mittag	mI/tAc
mitten	mI/tN
mittlerweile	mIt/lR/v1/l@
modernen	mo/der/nN
mohrrübe	mo/ry/b@
mohrrüben	mo/ry/bN
mohrrübensaft	mo/ry/bN/zAft
moment	mo/mEnt
mond	mOnt
morgen	mOr/gN
morgens	mOr/gNs
moritz	mo/rIT
motorrad	mo/to/rAt
mumpsbacken	mUmps/ba/kN
mund	mUnt
mundharmonika	mUnt/hAr/mo/ni/kA
munter	mUn/tR
musik	mu/zik
muss	mUs
musst	mUst
musste	mU/st@
mussten	mU/stN
musstes	mU/st@s
mutter	mU/tR
mutters	mU/tRs
myrthe	myr/t@
myrthes	myr/t@s
möbel	mq/bL
möcht	mQxt
möchte	mQx/t@
möchtest	mQx/t@st
möglich	mQ/glIc
müde	my/d@
müder	my/dR
mühelos	my/@/los
mühle	my/l@
müll	mYl
müsli	mys/li
müssen	mYs/N
müssn	mYs/N
müsst	mYst
müsste	mY/st@
mütze	mY/T@
n	N
na	nA
nach	nAx
nachgesagt	nAx/g@/zagt
nachher	nAx/her
nachmachen	nAx/mAx/N
nachrichten	nAx/rIc/tN
nachsagt	nAx/zagt
nacht	nAxt
nackdei	nAk/d1
nackedei	nA/k@/d1
nackig	nA/kIc
nadel	na/dL
naechste	nEc/st@
naechstes	nEc/st@s
naegel	ne/gL
naeh	ne
naehen	ne/N
naeherst	ne/Rst
naemlich	nem/lIc
naja	nA/jA
namen	na/mN
nani	na/ni
nase	na/z@
nasenloch	na/zN/lox
naseputzen	na/z@/pu/TN
nashorn	nAs/horn
nashörner	nAs/hQr/nR
nashörnern	nAs/hQr/nRn
nass	nAs
nasse	nAs/@
nassen	nAs/N
nassgespritzt	nAs/g@/SprITt
natürlich	nA/tyr/lIc
ne	n@
neben	ne/bN
nebenbei	ne/bM/b1
nee	ne
nehm	nem
nehme	ne/m@
nehmen	ne/mN
nein	n1n
nena	ne/na
nenas	ne/nas
nennt	nEnt
nesa	ne/zA
nest	nEst
nette	nE/t@
neu	n2
neue	n2/@
neuen	n2/N
neuer	n2/R
neuerdings	n2/R/dings
neues	n2/@s
neulich	n2/lIc
neun	n2n
neunten	n2n/tN
neunundzwanzigster	n2/nund/Tvan/TIg/stR
neunzehnhundertachtundachzig	n2n/Te/nhun/der/tax/tun/tax/TIc
neunzehnte	n2n/Ten/t@
neunzehnten	n2n/Ten/tN
neunzehnter	n2n/Ten/tR
neustem	n2/stM
nicht	nIct
nichts	nIcts
nicki	nI/ki
nie	ni
niemand	ni/mAnt
nilpferd	nIl/Pert
nimm	nIm
nimmst	nImst
ning	nInc
nippel	nI/pL
nix	nIx
noch	nOx
nochmal	nOx/mAl
nochn	nOx/N
normale	nOr/mA/l@
november	no/fEm/bR
null	nul
nun	nUn
nur	nur
nussschokolade	nus/So/ko/lA/d@
nö	nq
ob	Op
oben	o/bN
objekt	Op/jEkt
objekte	Op/jEk/t@
objekten	Op/jEk/tN
objektnamen	Op/jekt/na/mN
obst	Opst
obwohl	Op/vol
och	Ox
oder	o/dR
ofen	o/fN
offen	O/fN
oft	Oft
oh	o
ohne	o/n@
ohr	Or
ohren	O/rN
oktober	Ok/to/bR
olympiamünze	O/lym/pi/a/myn/T@
omi	o/mI
orange	o/rAn/J@
ordnung	Ord/nUnc
otto	O/to
paar	par
pack	pAk
packen	pA/kN
packst	pAkst
packt	pAkt
palme	pAl/m@
pampelmuse	pAm/pL/mu/z@
papi	pA/pi
papier	pA/pir
papis	pA/pis
pappi	pA/pi
pappis	pA/pis
parfum	pAr/fum
pass	pAs
passen	pAs/N
passieren	pAs/i/rN
passiert	pAs/irt
passsiert	pAs/irt
passt	pAst
pelikan	pE/lI/kAn
perlchen	perlx/N
perlen	per/lN
perlenkette	per/lN/kE/t@
pfau	P3
pfeife	P1/f@
pfeift	P1ft
pferd	Pert
pferdchen	Pert/cN
pferde	Per/d@
pferden	Per/dN
pflaster	PlA/stR
pflaume	Pl3/m@
pflaumen	Pl3/mN
pflaumenstein	Pl3/mN/St1n
pflücken	PlY/kN
phantasie	fAn/tA/zi
pickst	pikst
piekst	pikst
pieps	pips
pietz	piT
pilot	pi/lot
pilz	pIlT
pimmchen	pIm/cN
pimpchen	pImp/cN
pimpelchen	pIm/pL/cN
plabbert	plA/bRt
plaetze	plE/T@
platsch	plAC
platt	plAt
platz	plaT
plfaumenstein	Pl3/mN/st1n
plumpplurie	plUm/plu/ri
plötzlich	plQT/lIc
po	po
poh	po
pony	po/ni
ponys	po/nis
popeln	po/pLn
popo	po/po
positive	pO/zI/ti/f@
post	pOst
postkarte	pOst/kAr/t@
prag	prac
prima	pri/mA
pritscheln	prI/CLn
probier	pro/bir
probieren	pro/bi/rN
probiern	pro/bi/rN
probiers	pro/birs
probiert	pro/birt
produziert	prO/du/Tirt
prozedur	pro/Te/dur
pru	pru
pröstchen	prqst/cN
puck	pUk
pulli	pU/li
pullover	pU/lo/fR
puma	pu/ma
puppe	pU/p@
purzelbaum	pUr/TL/b3m
pusten	pu/stN
pustet	pu/st@t
putz	pUT
putzen	pU/TN
puzzel	pUT/TL
puzzle	pUTT/l@
pünktchen	pYnkt/cN
püppchen	pYp/cN
quackel	kvA/kL
quak	kvak
quasi	kva/zI
quatscht	kvACt
quieckt	kvikt
qürgemalten	kver/g@/mal/tN
rabs	rAps
raeuber	r2/bR
raeuberhauptmann	r2/bR/h3pt/mAn
raeum	r2m
raeumlichen	r2m/lI/cN
raeumst	r2mst
raeumt	r2mt
rand	rAnt
ranzukommen	rAn/Tu/kO/mN
raps	rAps
rasenmaeher	ra/zN/me/R
raubtier	r3b/tir
rauf	r3f
raufgefahrn	r3f/g@/fa/rN
raufgehen	r3f/ge/N
raufgeklettert	r3f/g@/kl3/tRt
raufklettern	r3f/klE/tRn
raum	r3m
raupe	r3/p@
raupen	r3/pN
raus	r3s
rausbrechen	r3s/brE/cN
rauschenden	r3/SEn/dN
rauschleudern	r3/Sl2/dRn
rausgefallen	r3s/g@/fA/lN
rausgehen	r3s/ge/N
rausgeklettert	r3s/g@/klE/tRt
rausgekomm	r3s/g@/kOm
rausgekommen	r3s/g@/kO/mN
rausgemolken	r3s/g@/mOl/kN
rausguckt	r3s/gUkt
rausholem	r3s/ho/lN
rausholen	r3s/ho/lN
rauskommen	r3s/kO/mN
rausmachen	r3s/mAx/N
rausnehmen	r3s/ne/mN
rauss	r3s
raussgefallen	r3s/g@/fA/lN
raustun	r3/stun
reaktionen	re/Ak/Ti/o/nN
recht	rEct
rede	re/d@
reden	re/dN
regal	re/gal
regalchen	re/gal/cN
regen	re/gN
regnete	reg/n@/t@
reh	re
reicht	r1ct
reif	r1f
reihe	r1/@
reihenfolgen	r1/N/fol/gN
rein	r1n
reindrücken	r1n/dry/kN
reinfangen	r1n/fAn/gN
reingehopst	r1n/g@/hOpst
reingeregnet	r1n/g@/reg/n@t
reingesprungen	r1n/g@/SprUn/gN
reingetan	r1n/g@/tan
reingucken	r1n/gU/kN
reinsteigen	r1n/St1/gN
reintun	r1n/tun
reissverschluss	r1s/fer/Slus
reiten	r1/tN
reiter	r1/tR
reserve	re/zer/f@
richtig	rIc/tIc
richtige	rIc/tI/g@
richtigen	rIc/tI/gN
richtiger	rIc/tI/gR
richtiges	rIc/tI/g@s
riechen	ri/cN
riechst	ricst
riecht	rict
riesenweib	ri/zen/v1p
ring	rinc
ringkampf	ring/kAmP
ritz	rIT
robben	rO/bN
rollen	rO/lN
roller	rO/lR
rollt	rOlt
rot	rot
rote	ro/t@
roten	ro/tN
roter	ro/tR
rotes	ro/t@s
rubbel	rU/bL
rubbeln	rU/bLn
ruberto	ru/ber/to
rucksack	ruk/zak
rufen	ru/fN
rufst	rufst
ruhe	ru/@
ruhig	ru/Ic
rum	rum
rumlaufen	rum/l3/fN
rummattern	rum/mA/tRn
rumpopeln	rum/po/pLn
rumsausen	rum/z3/zN
rumschmeissen	rum/Sm1s/N
rumschmiern	rum/Smirn
rumschmierst	rum/Smirst
rumschmiert	rum/Smirt
rumzisseln	rum/TIs/Ln
rumzumachen	rum/Tu/mAx/N
rund	rUnt
runter	rUn/tR
runteressen	rUn/tR/Es/N
runterfaellst	rUn/tR/fElst
runterfaellt	rUn/tR/fElt
runtergefallen	rUn/tR/g@/fA/lN
runtergefalln	rUn/tR/g@/fAln
runtergenommen	rUn/tR/g@/nO/mN
runterkommen	rUn/tR/kO/mN
runterschmeissen	rUn/tR/Sm1s/N
ruperto	ru/ber/to
rupfen	rU/PN
russland	rus/lant
rutsch	ruC
rutsche	rut/S@
rutschen	rut/SN
rübe	ry/b@
rübersteichen	ry/bR/St1/cN
rücken	rY/kN
rüssel	rYs/L
rüstung	rY/stUnc
sache	zAx/@
sachen	zAx/N
saecke	zE/k@
saege	ze/g@
saegewerk	ze/g@/verk
saengerin	zEn/gR/In
saetze	zE/T@
saeule	z2/l@
saft	zAft
sag	zac
sage	za/g@
sagen	za/gN
sager	za/gR
sagst	zacst
sagt	zagt
sagte	zag/t@
sagtn	zag/tN
sah	za
salamader	zA/lA/man/dR
salamander	zA/lA/man/dR
salat	zA/lat
salatsouce	zA/lat/zos/@
salbe	zAl/b@
salto	zAl/to
sammeln	zA/mLn
samt	zAmt
sand	zAnt
sandalen	zAn/da/lN
sandro	zAn/dro
sani	za/ni
satt	zAt
sauber	z3/bR
saubermachen	z3/bR/mAx/N
sauer	z3/R
sauerei	zy/r1
saus	z3s
sausen	z3/zN
saust	z3st
schachtel	SAx/tL
schade	Sa/d@
schaefchen	Sef/cN
schaetzchen	SET/cN
schaf	Saf
schafe	Sa/f@
schafen	Sa/fN
scharf	SArf
schatz	SAT
schau	S3
schauen	S3/N
schaufel	S3/fL
schaufeln	S3/fLn
schaukel	S3/kL
schaukelpferd	S3/kL/Pert
schaukelt	S3/kLt
schaun	S3/N
schaut	S3t
scheint	S1nt
schenk	SEnk
schenken	SEn/kN
schenkst	SEnkst
schere	Se/r@
scheunentor	S2/nN/tor
scheusslich	S2s/lIc
schick	SIk
schicken	SI/kN
schickt	SIkt
schieben	Si/bN
schiebt	Sipt
schief	Sif
schier	Sir
schiet	Sit
schietchen	Sit/cN
schiff	SIf
schiffchen	SIf/cN
schiffe	SI/f@
schildkröte	SIlt/krq/t@
schildkröten	SIlt/krq/tN
schimpfst	SImPst
schirme	SIr/m@
schlaefchen	Slef/cN
schlaefst	Slefst
schlaeft	Sleft
schlaf	Slaf
schlafanzug	Sla/fAn/Tuc
schlafen	Sla/fN
schlafzimmer	Slaf/TI/mR
schlange	SlAn/g@
schlecht	SlEct
schlechte	SlEc/t@
schleife	Sl1/f@
schleifen	Sl1/fN
schlimm	SlIm
schlimmes	SlI/m@s
schluss	SlUs
schlüssel	SlYs/L
schmarren	SmA/rN
schmeckt	SmEkt
schmeiss	Sm1s
schmeissen	Sm1s/N
schmeisst	Sm1st
schmetterling	SmE/tR/linc
schmetterlinge	SmE/tR/lin/g@
schmier	Smir
schmiererei	Smi/rR/1
schmiern	Smirn
schmiers	Smirs
schmierst	Smirst
schmiert	Smirt
schmuck	SmUk
schmuckstück	SmUk/stYk
schmusemaus	Smu/z@/m3s
schmutzwaesche	SmU/TvE/S@
schnabel	Sna/bL
schnappen	SnA/pN
schnapsideen	SnAps/i/de/N
schnatterliese	SnA/tR/li/z@
schnattern	SnA/tRn
schnecke	SnE/k@
schnecken	SnE/kN
schneckenpost	SnE/kN/pOst
schnee	Sne
schneid	Sn1t
schneiden	Sn1/dN
schnell	SnEl
schnibbel	SnI/bL
schnibbelchen	SnI/bL/cN
schnuller	SnU/lR
schnupfen	SnU/PN
schnuppen	SnU/pN
schnöbbel	SnQ/bL
schnöbbelbraten	SnQ/bL/bra/tN
schnöbbelchen	SnQ/bL/cN
schnöbbelhase	SnQ/bL/ha/z@
schnöbbelmaus	SnQ/bL/m3s
schnön	Sqn
schokolade	So/ko/lA/d@
schokoladenjoghurt	So/ko/lA/dN/jo/gurt
scholli	SO/li
schon	Son
schoss	SOs
schrank	SrAnk
schreck	SrEk
schreibtisch	Sr1b/tIS
schreien	Sr1/N
schreitn	Sr1/tN
schriftzeichen	SrIf/T1/cN
schritte	SrI/t@
schub	SUp
schubbern	SU/bRn
schublade	SU/pla/d@
schubst	SUpst
schuh	Su
schuhe	Su/@
schuppsen	SUp/zN
schuppst	SUpst
schwabt	Svapt
schwackelschwanz	SvA/kL/SvAnT
schwan	Svan
schwanz	SvAnT
schwappt	SvApt
schwarz	SvArT
schwarze	SvAr/T@
schwarzen	SvAr/TN
schwarzes	SvAr/T@s
schweigen	Sv1/gN
schwein	Sv1n
schweine	Sv1/n@
schweinen	Sv1/nN
schweinerei	Sv1/nR/1
schwer	SvR
schwimm	SvIm
schwimmbad	SvIm/bAt
schwimmbadbild	SvIm/bAt/bIlt
schwimmbadbuch	SvIm/bAt/bux
schwimmen	SvI/mN
schwimmt	SvImt
schöbbelchen	SnQ/bL/cN
schön	Sqn
schöne	Sq/n@
schönen	Sq/nN
schönes	Sq/n@s
schürze	SYr/T@
schüttelst	SY/tLst
schüttelt	SY/tLt
sebastian	ze/bA/sti/An
sechs	zeks
sechshundert	zeks/hun/dRt
sechster	zEc/stR
sechzehnter	zeks/Ten/tR
see	ze
seehunde	ze/hUn/d@
seehunden	ze/hUn/dN
segen	ze/gN
seh	ze
sehen	ze/N
sehn	ze/N
sehr	zer
sei	z1
seid	z1t
seife	z1/f@
seifenblasen	z1/fN/bla/zN
seim	z1m
sein	z1n
seine	z1/n@
seinem	z1/nM
seinen	z1/nN
seiner	z1/nR
seit	z1t
seite	z1/t@
seiten	z1/tN
selber	zEl/bR
selbst	zElbst
september	zEp/tEm/bR
setz	zET
setzen	zE/TN
setzt	zETt
setzte	zET/t@
sibirien	zI/bi/ri/N
sich	zIc
sicher	zI/cR
sicherheit	zI/cR/h1t
sie	zi
sieben	zi/bN
siebte	zib/t@
siehst	zist
siehstn	zi/stN
sieht	zit
sies	zis
simon	zI/mon
sind	zInt
sing	zInc
singen	zIn/gN
singn	zIn/gN
singst	zIncst
singt	zIngt
sinne	zI/n@
situationen	zI/tu/a/Ti/O/nN
sitz	zIT
sitzen	zI/TN
sitzt	zITt
sitztn	zIT/tN
so	zo
socken	zO/kN
sofort	zo/fOrt
sogar	zo/gAr
solange	zo/lan/g@
solche	zOl/c@
solchen	zOl/cN
soll	zOl
sollen	zO/lN
solln	zO/lN
solls	zOls
sollst	zOlst
sollt	zOlt
som	zom
sondern	zOn/dRn
sone	zo/n@
sonne	zO/n@
sonnenblumenkern	zO/nN/blu/mN/kern
sonst	zOnst
sonsten	zOn/stN
sophie	zo/fi
sowas	zo/vas
sowieso	zo/vi/zo
sozialen	zO/Ti/A/lN
spaeter	Spe/tR
spazieren	SpA/Ti/rN
spaziergang	SpA/Tir/gAnc
spiegel	Spi/gL
spiel	Spil
spiele	Spi/l@
spielen	Spi/lN
spieln	Spi/lN
spielplatz	Spil/plAT
spielsachen	Spil/zAx/N
spielt	Spilt
spinne	SpI/n@
spitz	SpIT
spitze	SpI/T@
sprechen	SprE/cN
springen	SprIn/gN
springt	SprIngt
spritz	SprIT
spucke	SpU/k@
spulen	Spu/lN
stadt	StAt
staerker	Ster/kR
stall	stAl
stand	StAnt
stark	StArk
staub	St3p
stechen	StE/cN
steck	StEk
steckdosen	StEk/do/zN
stecken	StE/kN
steckspiel	StEk/Spil
steckt	StEkt
steh	St@
stehen	Ste/N
stehn	StN
stehst	Stest
steht	Stet
steig	St1c
steigen	St1/gN
steigt	St1gt
stein	St1n
steine	St1/n@
stell	StEl
stelle	StE/l@
stellen	StE/lN
stelln	StE/lN
stellst	StElst
stellt	StElt
sterne	Ster/n@
sticht	StIct
stiefeln	Sti/fLn
stift	StIft
stifte	StIf/t@
stimmt	StImt
stinkhose	StInk/ho/z@
stinkmüll	StInk/myl
stinkt	StInkt
stoffhasen	StOf/ha/zN
storch	StOrc
storchenelternpaar	StOr/cN/El/tRn/par
strasse	StrAs/@
strassenbau	StrAs/N/b3
streicheln	Str1/cLn
streichelt	Str1/cLt
streichen	Str1/cN
streiten	Str1/tN
stricknadel	StrI/kna/dL
strickzeug	StrIk/T2c
strumpf	StrUmP
strumpfhose	StrUmP/ho/z@
strumpfhosen	StrUmP/ho/zN
strümpfe	StrYm/P@
stuhl	Stul
stuss	StUs
störche	Stqr/c@
stösst	Stqst
stück	StYk
stückchen	StYk/cN
stühlchen	Styl/cN
stühle	Sty/l@
suabermachen	z3/bR/mAx/N
such	zux
suche	zux/@
suchen	zux/N
suchst	zuxst
sucht	zuxt
susanne	zu/za/n@
söckchen	zQk/cN
süden	zy/dN
süss	zys
süsse	zys/@
süsses	zys/@s
ta	ta
tage	ta/g@
tagen	ta/gN
tante	tAn/t@
tanten	tAn/tN
tanze	tAn/T@
tanzen	tAn/TN
tanzt	tAnTt
tapfer	tA/PR
tapp	tAp
tasche	tA/S@
taschentuch	tA/SN/tUx
tasse	tAs/@
tatsache	tAt/zAx/@
taucht	t3xt
tausendneunzig	t3/zNt/n2n/TIc
tausendsten	t3/zEnt/stN
teddybaer	tE/di/ber
tee	te
teich	t1c
teile	t1/l@
telefon	te/l@/fon
telefoniert	te/l@/fO/nirt
teller	tE/lR
teppich	tE/pIc
terrortyp	tE/ror/tYp
tesafilm	te/zA/fIlm
teufel	t2/fL
teufelchen	t2/fL/cN
teufli	t2/fli
thomas	to/mAs
tiefen	ti/fN
tier	tir
tierbilderbuch	tir/bIl/dR/bux
tiere	ti/r@
tieren	ti/rN
tierlaute	tir/l3/t@
tiern	ti/rN
tiger	ti/gR
tim	tIm
timpetu	tIm/pe/tu
tisch	tIS
tobt	topt
toll	tOl
tolle	tO/l@
tollen	tO/lN
toller	tO/lR
tolles	tO/l@s
tomate	to/mA/t@
tomaten	to/mA/tN
ton	ton
tonband	ton/bAnt
topf	tOP
tor	tor
torkelig	tOr/kL/Ic
tot	tot
total	tO/tal
trampeln	trAm/pLn
traurig	tr3/rIc
trecker	trE/kR
trekker	trE/kR
trennung	trE/nUnc
treppe	trE/p@
treten	tre/tN
trink	trInk
trinken	trIn/kN
trinkt	trInkt
triumph	tri/Umf
triumphiert	tri/Um/firt
trocknet	trO/kn@t
trotzdem	trOT/dem
trotzphase	trOT/fa/z@
tschüss	CYs
tu	tu
tun	tun
turm	turm
turner	tur/nR
turnt	turnt
tus	tus
tust	tust
tut	tut
tutenchamun	tu/tN/ca/mun
typen	tY/pN
töne	tq/n@
tücher	ty/ChR
tür	tyr
tüte	ty/t@
uhr	ur
uhren	u/rN
uhu	u/hu
um	um
umblaettern	um/blE/tRn
umdrehen	um/dre/N
umfaellst	um/fElst
umfaellt	um/fElt
umgedreht	um/g@/dret
umgefallen	um/g@/fa/lN
umgefalln	um/g@/fa/lN
umgehaengt	um/g@/hEngt
umgeschmissen	um/g@/SmIs/N
umgestellt	um/g@/stElt
umhin	um/hIn
umkippen	um/kI/pN
ummachen	um/mAx/N
umschmeissen	um/Sm1s/N
umsonst	um/zOnst
unbedingt	un/b@/dIngt
und	Unt
unfall	Un/fAl
ungeduldig	un/g@/dul/dIc
ungefaehr	un/g@/fer
unheimlich	nh1m/lIc
uni	u/ni
uns	Uns
unser	Un/zR
unsere	Un/zR/@
unserm	Un/zR/M
unsre	Uns/R/@
unten	Un/tN
unter	Un/tR
untergetaucht	Un/tR/g@/t3xt
unterm	Un/tR/M
unternehmungen	Un/tR/ne/mUn/gN
unterschied	Un/tR/Sit
unterwegs	Un/tR/vecs
ute	u/t@
utemarie	u/t@/mA/ri
verband	fer/bAnt
verbrannt	fer/brAnt
verdacht	fer/dAxt
verfüngliches	fer/fyn/glI/c@s
vergessen	fer/gEs/N
verklemmt	fer/klEmt
verlangt	fer/lAngt
verliern	fer/li/rN
verloren	fer/lo/rN
verpasst	fer/pAst
verputzt	fer/pUTt
verrückt	fe/rYkt
verschiedenen	fer/Si/dN/N
verschlingt	fer/SlIngt
verschluckst	fer/SlUkst
verschwindet	fer/SvIn/d@t
versehen	fer/ze/N
versprochen	fer/SprOx/N
verstaut	fer/St3t
versteckt	fer/StEkt
versteh	fer/St@
verstehen	fer/Ste/N
versteht	fer/Stet
verstreichen	fer/Str1/cN
versuch	fer/zux
versuchen	fer/zux/N
versuchs	fer/zuxs
versucht	fer/zuxt
verwendet	fer/vEn/d@t
viel	fil
viele	fi/l@
vielen	fi/lN
vieles	fi/l@s
vielleicht	fi/l1ct
vier	fir
vierte	fir/t@
vierzehnter	fir/Ten/tR
vitam	fI/tam
vitambrot	fI/tam/brot
vogel	fo/gL
voll	fOl
vollgemalt	fOl/g@/malt
vom	fOm
von	fOn
vor	fOr
vorach	fO/rax
vorbei	fOr/b1
vorher	fOr/her
vorhin	fOr/hIn
vorichtig	fo/rIc/tIc
vorischt	for/zIct
vorlesen	fOr/le/zN
vorne	fOr/n@
vorsicht	fOr/zIct
vorsichtig	fOr/zIc/tIc
vorwaerts	fOr/verts
vögel	fq/gL
vögelchen	fq/gL/cN
völlig	fQ/lIc
wach	vAx
wacht	vAxt
wackelnschwanz	vA/kL/SvAnT
wackelschwanz	vA/kL/SvAnT
waer	ver
waerter	ver/tR
waesche	vE/S@
wagen	vA/gN
waggons	vA/gons
wahnsinn	van/zIn
wahnsinnger	van/zIn/gR
wahnsinnig	van/zI/nIc
wald	vAlt
waltraut	vAl/tr3t
wan	vAn
wand	vAnt
wann	vAn
war	vAr
ward	vArt
waren	va/rN
warm	vArm
warn	vArn
wars	vArs
warst	vArst
wart	vArt
warte	vAr/t@
warten	vAr/tN
wartet	vAr/t@t
warum	vA/rum
was	vAs
waschen	vA/SN
waschlappen	vA/SlA/pN
waschmaschine	vA/SmA/SI/n@
wasn	vAs/N
wasser	vAs/R
wasserblasen	vAs/R/blA/zN
watte	vA/t@
weberknecht	ve/bR/knect
wecken	vE/kN
weg	vEc
wegbringen	vEc/brIn/gN
weggefahren	vEc/g@/fa/rN
weggeflogen	vEc/g@/flo/gN
weggegangen	vEc/g@/gAn/gN
weggehen	vEc/ge/N
weggelaufen	vEc/g@/l3/fN
weggenommen	vEc/g@/nO/mN
weggeraeumt	vEc/g@/r2mt
weggeschmissen	vEc/g@/SmIs/N
weglegen	vEc/le/gN
wegnehme	vEc/ne/m@
wegschmeissen	vEc/Sm1s/N
weh	ve
wehgetan	ve/g@/tAn
wehtun	ve/tun
wehtut	ve/tut
wei	v1
weihnachtsbaum	v1/nAxts/b3m
weil	v1l
weils	v1ls
weinen	v1/nN
weint	v1nt
weise	v1/z@
weiss	v1s
weisse	v1s/@
weissen	v1s/N
weisser	v1s/R
weisst	v1st
weit	v1t
weiter	v1/tR
weiterblaettern	v1/tR/blE/tRn
weitere	v1/tR/@
weiteressen	v1/tR/Es/N
weitergehen	v1/tR/ge/N
weitergucken	v1/tR/gU/kN
weiterhin	v1/tR/hIn
weiterrutsch	v1/tR/rUC
welch	vElc
welche	vEl/c@
welchen	vEl/cN
welcher	vEl/cR
welches	vEl/c@s
welsch	vElS
wem	vem
wen	ven
wenig	ve/nIc
weniger	ve/nI/gR
wenn	vEn
wenns	vEns
wenzel	vEn/TL
wer	ver
werd	vert
werden	ver/dN
werdn	ver/dN
werfen	ver/fN
wespe	vEs/p@
wespen	vEs/pN
wichtel	vIc/tL
wichtelhausen	vIc/tL/h3/zN
wichtelmaennern	vIc/tL/mE/nRn
wichtelmann	vIc/tL/mAn
wichtig	vIc/tIc
wickeln	vI/kLn
wie	vi
wieder	vi/dR
wiederentdeckt	vi/dR/Ent/dEkt
wiederkomm	vi/dR/kOm
wiese	vi/z@
wiesen	vi/zN
wieso	vi/zo
wieviel	vi/fil
wieviele	vi/fi/l@
wievielten	vi/fil/tN
wild	vIlt
will	vIl
willi	vI/li
willst	vIlst
wimer	vi/mR
windel	vIn/dL
winke	vIn/k@
winken	vIn/kN
winkt	vInkt
winter	vIn/tR
wir	vir
wird	virt
wirf	virf
wirklch	vir/klIc
wirklich	vIr/klIc
wirst	virst
wisch	vIS
wischt	vISt
wissen	vIs/N
wisst	vIst
witzig	vI/TIc
witzigerweise	vI/TI/gR/v1/z@
wo	vo
wobei	vo/b1
woche	vOx/@
wochen	vOx/N
wohl	vol
wohnen	vo/nN
wohnt	vont
wohnungen	vo/nUn/gN
wohnwagen	von/vA/gN
wolf	vOlf
woll	vOl
wollen	vO/lN
wollst	vOlst
wollt	vOlt
wollte	vOl/t@
wollten	vOl/tN
wolltest	vOl/t@st
wort	vOrt
wortaeusserung	vOr/t2s/e/rUnc
worte	vOr/t@
wortstellungsvarianten	vOrt/StE/lUngs/fa/rI/an/tN
wos	vos
wumm	vUm
wund	vUnt
wurm	vUrm
wurst	vUrst
wurstbrot	vUrst/brot
wölfe	vQl/f@
wörter	vQr/tR
wühlen	vy/lN
yang	y/Anc
zack	TAk
zaehl	Tel
zaehlen	Te/lN
zaehne	Te/n@
zaehnen	Te/nN
zahn	Tan
zebra	Te/brA
zebras	Te/brAs
zeh	Te
zehnmarkstück	Ten/mArk/stYk
zeichnet	T1c/n@t
zeig	T1c
zeigen	T1/gN
zeigt	T1gt
zeigte	T1g/t@
zeit	T1t
zeitliche	T1t/lI/c@
zeitung	T1/tUnc
zelt	TElt
zerknickelt	Ter/knI/kLt
zerpflückt	Ter/PlYkt
zerrissen	Te/rIs/N
zettel	TE/tL
zeug	T2c
ziege	Ti/g@
ziegen	Ti/gN
ziegenböckchen	Ti/gN/bqk/cN
zieh	Ti
ziehen	Ti/N
ziehn	Ti/N
ziehst	Tist
zieht	Tit
zielt	Tilt
ziemlich	Tim/lIc
ziemliche	Tim/lI/c@
zimmer	TI/mR
zirkus	TIr/kus
zoo	To
zora	TO/ra
zotteldinger	TO/tL/dIn/gR
zu	Tu
zuerst	Tu/erst
zug	Tuc
zugeleimt	Tu/g@/l1mt
zugemacht	Tu/g@/mAxt
zugeschaut	Tu/g@/S3t
zugucken	Tu/gU/kN
zum	Tum
zumachen	Tu/mAx/N
zumindest	Tu/mIn/d@st
zunge	TUn/g@
zupfen	TU/PN
zur	Tur
zurück	Tu/rYk
zusamm	Tu/zA/mN
zusammen	Tu/zA/mN
zusammenmachen	Tu/zA/mN/mAx/N
zusammgekracht	Tu/zAm/g@/kraxt
zuschnappen	Tu/SnA/pN
zuviel	Tu/fil
zwack	TvAk
zwanzigster	TvAn/TIg/stR
zwar	TvAr
zwei	Tv1
zweien	Tv1/N
zweite	Tv1/t@
zweiten	Tv1/tN
zwerg	Tverc
zwick	TvIk
zwieback	Tvi/bAk
zwiebeln	Tvi/bLn
zwischendurch	TvI/SN/durc
zögern	Tq/gRn
öfters	qf/tRs
über	y/bR
überall	y/bR/Al
überhaupt	y/bR/h3pt
übrigen	y/brI/gN
übrigens	y/brI/gNs
üpfen	y/PN
