a	a
aaeh	ae
ab	Ap
abbeissen	Apb1sN
abend	abNt
aber	abR
abgebrochen	Apg@broxN
abgeholt	Apg@golt
abgemacht	Apg@mAxt
abgeschaut	Apg@S3t
abgeschnitten	Apg@SnItN
abgewaschen	Apg@vASN
abholen	ApholN
ablecken	AplEkN
abmachen	ApmAxN
abputzen	AppuTN
abreissen	Apr1sN
abschneiden	ApSn1dN
abstreifen	ApStr1fN
abwaschen	ApvASN
abwechselnd	ApvEkzLnt
abwischen	ApvISN
abziehn	ApTiN
abzumachen	ApTumAxN
abzuwischen	ApTuvISN
acht	Axt
adebar	adebar
adjektiven	AdjEktifN
aegypter	EgyptR
aehnlich	enlIc
aepfel	EPL
aeusserung	2sErUnc
affe	Af@
affen	AfN
afghanisches	AfganIS@s
ahnung	anUnc
alex	AlEx
alisia	AliziA
alle	Al@
allein	Al1n
alleine	Al1n@
allem	AlM
allerdings	AlRdIngs
alles	Al@s
allzu	AlTu
als	Als
also	Alzo
alt	Alt
alte	Alt@
alter	AltR
am	Am
ameise	am1z@
ameisen	am1zN
an	An
ander	AndR
andere	AndR@
anderen	AndRN
anderes	AndR@s
andern	AndRn
anders	AndRs
andersrum	AndRsrum
andre	andr@
andrea	andreA
andrere	AndrR@
andres	AndR@s
anducken	AndUkN
anfassen	AnfAsN
angeblich	AngeblIc
angefahren	Ang@farN
angefangen	Ang@fAngN
angeguckt	Ang@gUkt
angelaufen	Ang@l3fN
angenehm	Ang@nem
angeschaut	Ang@S3t
angezogen	Ang@TogN
angst	Ancst
angucken	AngUkN
anhalten	AnhAltN
anhaltetest	AnhAltEst
anhast	AnhAst
anmachen	AnmAxN
anmacht	AnmAxt
anmalen	AnmalN
anner	AnR
anrufen	AnrufN
ans	Ans
anschauen	AnS3n
anschaun	AnS3n
ansonsten	AnzOnstN
anspritzen	AnSprITN
anstaendig	AnStEndIc
anstrengend	AnStrEngNt
antworten	AntvOrtN
anziehen	AnTiN
anziehn	AnTiN
anziehsachen	AnTizAxN
anzug	AnTuc
apfel	APL
apparat	ApArAt
april	AprIl
arm	Arm
arme	Arm@
armer	ArmR
armreif	Armr1f
art	Art
attackieren	AtAkirN
auch	3x
auf	3f
aufessen	3fEsN
aufforderung	3forderUnc
auffressen	3ffrEsN
aufgeben	3fgebN
aufgefressen	3fg@frEsN
aufgegessen	3fg@gEsN
aufgenommen	3fg@nOmN
aufgewacht	3fg@vAxt
aufheben	3fhebN
aufhören	3fhqrN
aufmachen	3fmAxN
aufmüpfig	3fmYPIc
aufmüpfiger	3fmYPIgR
aufn	3fN
aufnahme	3fnam@
aufnahmen	3fnamN
aufnehmen	3fnemN
aufpassen	3fpAsN
aufraemen	3fr2mN
aufraeum	3fr2m
aufraeumen	3fr2mN
aufs	3fs
aufschlagen	3fSlagN
aufstehen	3fSteN
aufstehn	3fSteN
aufsteigen	3fst1gN
aufzufordern	3fTufOrdRn
auge	3g@
augen	3gN
aus	3s
ausbeute	3sb2t@
ausdrücke	3sdryk@
auseinander	3s1nAndR
auseinandermachen	3s1nAndRmAxN
ausgesucht	3sg@zuxt
ausgetrunken	3sg@trUnkN
ausgezogen	3sg@TogN
auskratzen	3skrATN
ausmachen	3smAxN
ausrangieren	3srangirN
ausser	3sR
ausserdem	3sRdem
aussortieren	3ssOrtirN
ausziehen	3sTiN
ausziehn	3sTin
auto	3to
autos	3tos
auziehen	3TiN
ayche	1S@
aysche	1S@
ayse	1S@
ayshe	1S@
ba	ba
babies	bebis
baby	bebi
babyaffen	bebiAfN
babybuch	bebibux
babynilpferd	bebinIlPert
babypony	bebiponi
bach	bax
badbuch	batbux
badefest	bad@fEst
badehose	bad@hoz@
badehosen	bad@hozN
badewanne	bad@van@
badezimmer	bad@TImR
baecker	bEkR
baelle	bEl@
baer	beR
baerchen	bercN
baeren	berN
baern	berN
baeume	b2m@
baeumen	b2mN
baeürin	b2rIn
bahnhof	banhof
bald	bAlt
balkon	bAlkon
ball	bAl
bamm	bAm
banane	bAnan@
bananen	bAnanN
band	bAnt
bank	bAnk
bastian	bAstjN
bau	b3
bauch	b3x
bauchweh	b3xve
baue	b3@
bauen	b3N
bauer	b3r
bauernhaeuser	b3rNh2sR
bauernhaus	b3rNh3s
bauernhof	b3rnhof
bauklötze	b3klqT@
bauklötzern	b3klqTRn
baum	b3m
baumt	b3mt
baustelle	b3stEl@
baut	b3t
becher	bEChR
becken	bEkN
befreie	b@fr1@
begeisterung	b@g1stRUnc
beginnt	b@gInt
begleitet	b@gl1tEt
bei	b1
beide	b1d@
beiden	b1dN
beim	b1m
bein	b1n
beinah	b1na
beine	b1n@
beinen	b1nN
beispiel	b1Spil
beiss	b1s
beissen	b1sN
beisst	b1st
bekommen	b@kOmN
bellt	bElt
benennungen	b@nEnUngN
berg	b@rc
berge	b@rg@
beschaetigen	b@SEtIgN
beschmiert	b@Smirt
beschreibend	b@Sr1bEnt
besonderes	b@zOndR@s
besonders	b@zOndRs
besser	bEsR
bessrer	bEsrR
bestehst	bEStest
besten	bEstN
bestens	bEstens
bestimmt	bEstImt
bestimmte	bEstImt@
besuch	b@zux
bett	bEt
bettchen	bEtcN
bettwaesche	bEtvES@
bettzeug	bET2c
beute	b2t@
beutel	b2tL
bezogen	b@TogN
biba	bIbA
bienchen	bincN
biene	bin@
bienen	binN
bild	bIlt
bilder	bIldR
bilderbuch	bIldRbux
bilderbücher	bIldRbyChR
bildern	bIldRn
bildet	bIldEt
bimmelbaehnchen	bImLbencN
bimmelbahn	bImLban
bimmelt	bImElt
bin	bIn
bindet	bIndEt
bis	bIs
bischen	bIscN
bisschen	bIscN
bissel	bIsL
bissschen	bIsSN
bist	bIst
bitte	bIt@
bitteschön	bIt@Sqn
blaeschen	blescN
blaettchen	blEtcN
blaetter	blEtR
blaettern	blEtRn
blatt	blAt
blau	bl3
blaue	bl3@
blauen	bl3N
bleib	bl1p
bleiben	bl1bN
bloss	blOs
blume	blum@
blumen	blumN
blumenwiesen	blumNvizN
blut	blut
blöd	blqt
blöder	blqdR
blümchen	blymcN
boden	bodN
bohnen	bonN
bord	bOrt
brauch	br3x
brauchen	br3xN
brauchst	br3xst
braucht	br3xt
braun	br3n
braune	br3n@
brav	brAf
bremst	brEmst
brennen	brEnN
brettchen	brEtcN
brief	brif
briefe	brif@
brille	brIl@
bring	brInc
bringen	brIngN
bringt	brIngt
brot	brot
brote	brot@
bröckchen	brQkcN
bröselei	brqzL1
brötchen	brqtcN
brücke	brYk@
buch	bux
bumm	bUm
bummelt	bUmLt
bums	bums
bunte	bUnt@
bus	bUs
butter	bUtR
bücher	bycR
büchlein	bycl1n
bügeln	bygLn
bügelt	bygLt
bürste	bYrst@
carola	CArolA
caroline	CArolin@
carolines	CArolin@s
chaos	kaOs
charakter	kAraktR
charlie	Sarli
charlies	Sarlis
charlotte	SArlOt@
charlottte	SArlOt@
charly	Sarlie
chic	ChIC
chiemsee	Chimze
chinesisches	cinezIS@s
claudia	kl3dia
clown	kl3n
creme	krEm
da	dA
dabei	dAb1
dach	dAx
dacht	dAxt
dachte	dAxt@
dacke	dAk@
dadran	dAdrAn
dadrauf	dAdr3f
dahin	dAhIn
dahinten	dAhIntN
damals	dAmAls
dame	dam@
damit	dAmIt
danach	dAnAx
danke	dAnk@
dankeschön	dAnk@Sqn
dann	dAn
darauf	dAr3f
daraufklettern	dAr3fklEtRn
daraus	dAr3s
darf	dArf
darfst	dArfst
das	dAs
dasn	dAsN
dass	dAs
dasselbe	dAsElb@
dasteht	dAStet
daumen	d3mN
davon	dAfOn
davorne	dAforn@
dawas	dAvAs
dazu	dATu
dazugelernt	dATug@lernt
dazwischen	dATvISN
decke	dEk@
deckel	dEkL
deim	d1m
dein	d1n
deine	d1n@
deinem	d1nM
deinen	d1nN
deiner	d1nR
deines	d1n@s
deinm	d1nM
deins	d1ns
dem	dem
den	den
denen	denN
denke	dEnk@
denken	dEnkN
denkst	dEnkst
denkt	dEnkt
denn	dEn
der	der
derweil	derv1l
desselben	dEsElbN
deswegen	dEsvegN
di	di
dibbel	dIbL
dich	dIc
dick	dIk
dicke	dIk@
dicken	dIkN
dicker	dIkR
dickes	dIk@s
dickmadame	dIkmadam@
die	di
diener	dinR
dies	dis
diese	diz@
diesen	dizN
dieser	disR
dieses	diz@s
diesmal	dismAl
dietzi	diTi
diezi	diTi
diezie	diTi
diezies	diTis
ding	dInc
dinge	dIng@
dinger	dIngR
dir	dir
direkt	dirEkt
direkte	dirEkt@
dirs	dirs
doch	dOx
dokter	dOktOr
doktor	dOktOr
dokumentiert	dOkumEntirt
doll	dOl
dolle	dOl@
dollen	dOlN
dolles	dOl@s
donner	dOnR
doof	dof
dran	drAn
drauf	dr3f
draufdrücken	dr3fdrYkN
draufgeklebt	dr3fg@klept
draufgemacht	dr3fg@mAxt
draufgemalt	dr3fg@malt
draufgeschreiben	dr3fg@Sr1bN
draufgesteckt	dr3fg@StEkt
draufgetan	dr3fg@tan
draufmachen	dr3fmAxN
draufmalen	dr3fmalN
draufstecken	dr3fStEkN
draufsteigen	dr3fSt1gN
draufstellen	dr3fStElN
drauftreten	dr3ftretN
drauftun	dr3ftun
draussen	dr3sN
dreck	drEk
dreckeckig	drEkIc
dreckfingern	drEkfIngRn
dreckhaenden	drEkhEndN
dreckig	drEkIc
drehen	dreN
dreht	dret
drei	dr1
dreimal	dr1mAl
dreirad	dr1rAt
drin	drIn
drinnen	drInN
drunter	drUntR
drüben	drybN
drüber	drybR
drück	dryk
drücken	drykN
dschidschi	JIJI
du	du
dumm	dUm
dumme	dUm@
dummes	dUm@s
dunkel	dUnkL
durch	dUrc
durchbrechen	dUrcbrEcN
durcheinander	dUrc1nAndR
durchgehen	dUrcgeN
durchkrabbeln	dUrckrAbLn
durchschneiden	dUrcSn1dN
dusche	duS@
duschen	duSN
dünn	dYn
dürfen	dYrfN
eben	ebN
ecke	Ek@
eckig	EkIc
eckliges	EklIg@s
edel	edL
eh	e
eher	eR
ehrlich	erlIc
ei	1
eichhörnchen	1chQrncN
eier	1R
eierlöffel	1RlQfL
eiern	1Rn
eigenes	1gN@s
eigenschaften	1gNSaftN
eigentlich	1gNtlIc
eimer	1mR
ein	1n
eindeutig	1nd2tIc
eindruck	1ndruk
eine	1n@
einem	1nM
einen	1nN
einer	1nR
einfach	1nfAx
eingang	1nganc
eingerissen	1ng@rIsN
eingesperrt	1ng@Spert
eingewickelt	1ng@vIkLt
eingezwickt	1ng@TvIkt
einige	1nIg@
einkaufen	1nk3fN
einkaufswagen	1nk3fsvagN
einmal	1nmAl
einordnen	1nOrdnN
einordnung	1nordnUnc
eins	1ns
einsatz	1nzAT
einschmiern	1nSmirN
einstecken	1nStEkN
einsteigen	1nSt1gN
einzelne	1nTEln@
einzelnen	1nTElnN
einzige	1nTIg@
eis	1s
eisbaer	1sbaR
eisenbahn	1zenban
eisenbahnen	1zenbanN
eismann	1smAn
eisschrank	1sSrAnk
eklige	eklIg@
elefant	ElEfAnt
elefanten	ElEfAntN
elfant	ElEfAnt
ende	End@
endlich	EntlIc
eng	Enc
engeln	EngLn
entchen	EntcN
ente	Ent@
enten	EntN
entsprechend	EntSprEcNt
entweder	EntvedR
entzündet	EnTYnd@t
er	er
erdbeere	Erdber@
erdbeeren	ErdberN
erdbeern	ErdberN
erde	Erd@
ereignis	Er1gnIs
erfolg	Erfolc
erhebe	erheb@
erika	ErIkA
erinner	erInR
erinnerst	erInRst
erinnert	erInRt
erkennt	erkEnt
erklaert	erklert
erschliessen	erSlisN
erschrack	erSrAk
erst	erst
ersten	erstN
erstes	erst@s
erstmal	erstmAl
erworben	ervOrbN
erzaehl	erTel
erzaehle	erTel@
erzaehlen	erTelN
erzaehln	erTelN
erzaehls	erTels
erzaehlst	erTelst
erzaehlt	erTelt
es	Es
esel	ezL
eseln	ezLn
ess	Es
essen	EsN
etwas	EtvAs
eu	2
euch	2c
eule	2l@
extra	EkstrA
fabi	fabi
faden	fadN
faehrt	fert
faellst	fElst
faellt	fElt
faengt	fEngt
fahren	farN
fahrn	farN
fahrzeuge	farT2g@
fall	fAl
falsche	fAlS@
familie	fAmilj@
famille	fAmilj@
fand	fAnt
fang	fAnc
fangen	fAngN
farbe	farb@
farben	farbN
farbwort	farbvOrt
fasan	fazan
fassen	fAsN
fast	fAst
fehlen	felN
fehlt	felt
fehltn	feltN
feige	f1g@
feigling	f1glInc
feld	fElt
fell	fEl
fenster	fEnstR
ferkel	ferkL
fertig	fertIc
fertigmachen	fertIcmAxN
fest	fEst
festgehalten	fEstg@hAltN
festgeklebt	fEstg@klept
festgemacht	fEstg@mAxt
festhalten	fEsthAltN
fettfingern	fEtfIngRn
fettig	fEtIc
feuer	f2R
feuerwehrauto	f2Rver3to
finde	fInd@
finden	fIndN
findest	fIndEst
finger	fIngR
fingerchen	fIngRcN
fingern	fIngRn
fingernaegel	fIngRnegL
fisch	fIS
fische	fIS@
fischen	fISN
flaeschchen	flEScN
flaeschchench	flEScN
flaeschen	flESN
flasche	flAS@
flaschen	flASN
flecken	flEkN
fleigt	fligt
fleisch	fl1S
fliege	flig@
fliegen	fligN
fliegt	fligt
flugzeug	fluxT2c
flugzeuge	fluxT2g@
fluss	flus
fortsetzung	fOrtzETUnc
fotoapparat	fotoaparat
frage	frag@
frageintonation	frag1ntonaTion
fragt	frAxt
frau	fr3
frauen	fr3N
frech	frEc
frechdachs	frEcdaxs
freche	frEc@
frechen	frEcN
frecher	frEcR
freches	frEc@s
fresse	frEs@
fressen	frEsN
freunde	fr2nd@
freust	fr2st
freut	fr2t
frisch	frIS
frische	frIS@
frischen	frISN
frisches	frIS@s
frisst	frIst
fritz	frIT
frosch	frOS
frösche	frQS@
früchte	frYct@
früh	fry
frühstück	fryStYk
frühstücken	frystYkN
früstücken	frystykN
fuchs	fuks
fuhr	fur
fuhrknecht	furknEct
furchtbar	fUrctbar
fuss	fus
fühlern	fylRn
führt	fyrt
fünf	fYnf
fünfmal	fYnfmal
für	fyr
fürn	fyrn
fürne	fyrn@
fürs	fyrs
füsse	fys@
füttert	fYtErt
gabel	gabL
gaby	gabi
gaehnen	genN
gaehnt	gent
gaense	gEnz@
gan	gan
gans	gAns
ganz	gAnT
ganze	gAnT@
ganzen	gAnTN
ganzer	gAnTR
ganzes	gAnT@s
gar	gar
gas	gas
gearde	g@rAd@
geb	g@p
gebaut	g@b3t
geben	gebN
gebissen	g@bIsN
geblaettert	g@blEtErt
geblieben	g@blibN
gebracht	g@brAxt
gebraucht	g@br3xt
geburtstag	g@burtstAc
geburtstagsgeschenke	g@burtstAgsg@SEnk@
geburtstagskuchen	g@burtstAgskuxN
gedacht	g@dAxt
gedanken	g@dAnkN
gefaehrlich	g@ferlIc
gefahren	g@farN
gefahrn	g@farN
gefallen	g@fAlN
gefalln	g@fAlN
gefang	g@fAnc
gefangen	g@fAngN
geflogen	g@flogN
gefragt	g@frAgt
gefressen	g@frEsN
gefunden	g@fUndN
gefüllt	g@fYlt
gegaehnt	g@gent
gegangen	g@gAngN
gegeben	g@gebN
gegen	gegN
gegend	gegEnt
gegenstaende	gegEnstEnd@
gegessen	g@gEsN
geglückt	g@glYkt
geguckt	g@gUkt
geh	ge
gehabt	g@hApt
gehaemmert	g@hEmErt
gehen	geN
gehn	geN
geholfen	g@hOlfN
geholt	g@holt
gehst	gest
geht	get
gehts	gets
gehörn	g@hqrn
gehört	g@hqrt
geier	g1R
gekaemmt	g@kEmt
gekauft	g@k3ft
gekitzelt	g@kITLt
geklappt	g@klApt
geklebt	g@klept
geklettert	g@klEtErt
geklopft	g@klOPt
geknickelt	g@knIkLt
gekomm	g@kOm
gekommen	g@kOmN
gekrabbelt	g@krAbLt
gekriegt	g@krigt
gelassen	g@lAsN
gelaufen	g@l3fN
gelb	gElp
gelbe	gElb@
gelben	gElbN
geld	gElt
gelder	gEldR
geleckt	g@lEkt
geleiert	g@l1Rt
gelesen	gElezN
gell	gEl
gelsen	gElzN
gemacht	g@mAxt
gemalt	g@malt
gemolken	g@mOlkN
gemütlich	g@mytlIc
gemütlicher	g@mytlIcR
genau	g@n3
genauso	g@n3zo
genomm	g@nOm
genommen	g@nOmN
genug	g@nuc
genügt	g@nygt
gepackt	g@pAkt
geparkt	g@pArkt
gepimpt	g@pImpt
gepustet	g@pust@t
geputzt	g@pUTt
gerade	g@rAd@
geraet	g@ret
gering	g@rInc
gerissen	g@rIsN
geritten	g@rItN
gern	gern
gerne	gern@
gerutscht	g@rUCt
gesagt	g@zAgt
gesaugt	g@z3gt
geschaftig	g@SAftIc
geschaukelt	g@S3kElt
geschenkt	g@SEnkt
geschichte	g@SIct@
geschimpft	g@SImPt
geschlafen	g@SlafN
geschmeide	g@Sm1d@
geschmekt	g@SmEkt
geschnitten	g@SnItN
geschrieben	g@SribN
geschupst	g@SUpst
geschwomm	g@SvOm
geschwommen	g@SvOmN
gesehen	g@zeN
gesehn	g@zeN
gesessen	g@zEsN
gesicht	g@zIct
gesichter	g@zIctR
gespielt	g@Spilt
gespritzt	g@SprITt
gesprungen	g@SprUngN
gessen	g@gEsN
gesteckt	g@StEkt
gestern	gEstErn
gestiegen	g@StigN
gestochen	g@StOxN
gestreichelt	g@Str1cElt
gestritten	g@StrItN
gesucht	g@zuxt
gesund	g@zUnt
gesungen	g@zUngN
getan	g@tan
getaucht	g@t3xt
getrunken	g@trUnkN
geturnt	g@turnt
gewalt	g@vAlt
gewaltigen	g@vAltIgN
gewaschen	g@vASN
geweih	g@v1
geweint	g@v1nt
gewesen	g@vezN
geworden	g@vOrdN
gewunken	g@vUnkN
gewütet	g@vyt@t
gezankt	g@TAnkt
gezeichnet	g@T1cn@t
gezeigt	g@T1gt
gezogen	g@TogN
gib	gIp
gibs	gIps
gibst	gIpst
gibt	gIpt
gibts	gIpts
ging	gInc
gingen	gIngN
giraffe	JIraf@
glaeser	glesR
glas	glas
glatt	glAt
glaub	gl3p
glaube	gl3b@
gleich	gl1c
gleiche	gl1c@
glocke	glOk@
glöckchen	glQkcN
glück	glYk
grad	grAt
grade	g@rAd@
gras	gras
grashüpfer	grashYPR
griff	grIf
grob	grop
gross	gros
grosse	gros@
grosseltern	grosEltRn
grossem	grosM
grossen	grosN
grosser	grosR
grosses	gros@s
grossmama	grosmAmA
grossmamma	grosmAmA
grossmutter	grosmUtR
grossvater	grosfatR
grossvaters	grosfatRs
gruppenbild	grupNbIlt
grösser	grqsR
grösstes	grqst@s
grün	gryn
grüne	gryn@
grünen	grynN
grüsse	grys@
guck	gUk
gucken	gUkN
guckst	gUkst
guckt	gUkt
gummi	gUmi
gummibaerchen	gUmibercN
gurke	gurk@
gut	gut
gute	gut@
guten	gutN
gutgegangen	gutg@gAngN
ha	hA
haare	har@
haaren	harN
haarkamm	harkAm
haarspange	harSpAng@
hab	hAp
habe	hAb@
haben	hAbN
habn	hAbN
habs	hAps
habt	hApt
haelt	hElt
haendchen	hEndcN
haende	hEnd@
haenden	hEndN
haeng	hEnc
haengst	hEnkst
haengt	hEnkt
haett	hEt
haette	hEt@
haettst	hEtst
haeufiger	h2fIgR
haeuschen	h2scN
hahn	han
hais	h1s
halbe	hAlb@
halli	hAlo
hallo	hAlo
hals	hAls
halsbrecherisch	hAlsbrEcRIS
halt	hAlt
halten	hAltN
hammer	hAmR
hampelmann	hAmpLmAn
hams	hAms
hamstern	hAmstRn
hand	hAnt
handlungen	hAndlUngN
handtuch	hAntux
hans	hAns
hantiert	hAntirt
happ	hAp
haps	hAps
hart	hArt
harten	hArtN
hase	haz@
hasen	hazN
hassan	hasan
hast	hAst
hat	hAt
hatn	hAtN
hats	hAts
hatte	hAt@
hatten	hAtN
hattest	hAtEst
haus	h3s
hause	h3z@
haut	h3t
he	h@
heben	hebN
heft	hEft
heia	h1A
heiabeia	h1ab1a
heidelberg	h1dLberc
heidrun	h1drun
heile	h1l@
heinrich	h1nrIc
heis	h1s
heiss	h1s
heissen	h1sN
heisst	h1st
heiterm	h1tRm
heizung	h1TUnc
hel	hEl
helfen	hElfN
hemd	hEmt
hemden	hEmdN
henri	hEnri
henrie	hEnri
henriettchen	hEnriEtcN
her	her
herd	hert
hergerichtet	herg@rIct@t
herniette	hEnriEt@
herrn	hern
herum	h@rum
herumgespenstert	h@rumg@spEnstRt
heu	h2
heuer	h2R
heuhupfer	h2hYPR
heuschrecke	h2SrEk@
heut	h2t@
heute	h2t@
hey	hei
hier	hir
hierrein	hirr1n
hilf	hIlf
hilfe	hIlf@
hilfst	hIlfst
hilft	hIlft
himmel	hImL
himpelchen	hImpLcN
hin	hIn
hinfallen	hInfAlN
hingefallen	hIng@fAlN
hingefalln	hIng@fAln
hingeführt	hIng@fyrt
hingekriegt	hIng@krict
hingekullert	hIng@kUlRt
hingelegt	hIng@legt
hingeschmiert	hIng@Smirt
hingeschrieben	hIng@SribN
hingestellt	hIng@StElt
hingetan	hIng@tan
hinlegen	hInlegN
hinnelegt	hIng@legt
hinsaust	hInz3st
hinsetzen	hInzETN
hinstellen	hInStElN
hinten	hIntN
hinter	hIntR
hintergrund	hIntRgrUnt
hinterher	hIntRher
hinterm	hInterM
hintun	hIntun
hirsche	hIrS@
hoch	hOx
hochgeklettert	hOxg@kl3t3rt
hochgezogen	hOxg@TogN
hochklettern	hOxkl3tRn
hof	hof
hoffentlich	hOf3ntlIc
hoffnung	hOfnUnc
hoher	hoR
hol	hol
holen	holN
holn	holN
holst	holst
holt	holt
holz	hOlT
holzstab	hOlTStap
holzwurm	hOlTvurm
honig	honIc
honigbrot	honIgbrot
hoppla	hOplA
horst	hOrst
hose	hoz@
hu	hu
hubschrauber	hupSr3bR
huhn	hun
hummel	hUmL
hund	hUnt
hunde	hUnd@
hundebaby	hUndebebi
hunger	hUngR
hupfen	hUPN
hupfst	hUPst
huppala	hopala
hut	hut
höhe	hq@
höhle	hql@
hör	hqr
höre	hqr@
hören	hqrN
hörn	hqrN
hörst	hqrst
hört	hqrt
hühner	hynR
hühnern	hynRn
hüllt	hYlt
hüpf	hYP
hüpfen	hYPN
hüpft	hYPt
ich	Ic
idee	ide
igel	igL
ihm	im
ihn	in
ihnen	inN
ihr	ir
ihre	ir@
ihrem	irM
ihren	irN
ihrer	irR
im	Im
imitiert	ImItirt
immer	ImR
immerzu	ImRTu
in	In
indianermaedchen	indiAnRmedcN
ineinander	In1nAndR
innen	InN
inner	InR
ins	Ins
interesant	IntErEsAnt
interessant	IntErEsAnt
interssantes	IntErEsAnt@s
inzwischen	InTvISN
irdenetwas	IrgEntEtvAs
irgend	IrgEnt
irgendetwas	IrgEntEtvAs
irgendwas	IrgEndvAs
irgendwelche	IrgEntvElc@
irgendwelchen	IrgEntvElcN
irgendwie	IrgEntvi
irgendwo	IrgEntvo
irre	Ir@
irres	Ir@s
irrsinnig	IrzInIc
irrsinniger	IrzInIgR
is	Ist
iss	Is
isses	Is@s
isst	Ist
ist	Ist
italien	italiN
ja	jA
jaa	jA
jacke	jak@
jaeger	jegR
jahr	jar
jahre	jar@
jang	jAnc
januar	jAnuar
jatzt	jATt
jawoll	jAvOl
jedenfalls	jedNfals
jeder	jedR
jedes	jed@s
jemand	jemAnt
jetz	jETt
jetzt	jETt
jeweils	jev1ls
jezt	jETt
jiangning	jAngnInc
jiau	jI3
joghurt	jogurt
johannesbeeren	johAnQsberN
jose	joz@
josephine	joz@fin@
juli	julI
jumbo	jUmbo
junge	jUng@
jungen	jUngN
junger	jUngR
juri	juri
jury	Juri
kaefer	kefR
kaelbchen	kElpcN
kaese	kez@
kaesebrot	kez@brot
kaestchen	kEstcN
kaetzchen	kETcN
kaffe	kAfe
kaffee	kAfe
kaffekanne	kAfekAn@
kalt	kAlt
kalte	kAlt@
kam	kam
kamel	kAmL
kamele	kAmEl@
kamelen	kAmElN
kamera	kAmErA
kamm	kAm
kann	kAn
kanne	kAn@
kanns	kAns
kannst	kAnst
kapiert	kapirt
kaput	kApUt
kaputt	kApUt
kaputtes	kApUt@s
kaputtgegangen	kApUtg@gAngN
kaputtgehen	kApUtgeN
karins	karins
karte	kArt@
kartoffel	kArtOfL
kartoffeln	kArtOfLn
kartoffelsaecke	kArtOfLzEk@
karton	kArton
kassette	kAsEt@
kassettenhülle	kAsEtenhyl@
katastrophe	kAtAstrof@
katze	kAT@
katzen	kATN
kauen	k3N
kauf	k3f
kaufen	k3fN
kauft	k3ft
kausalen	k3zalN
kein	k1n
keine	k1n@
keinen	k1nN
keiner	k1nR
keks	keks
kennst	kEnst
kennt	kEnt
kerne	kern@
kerze	kerT@
kerzen	kerTN
kette	kEt@
kichererbse	kIcRerbz@
kikereki	kIkRekI
kikiriki	kikiriki
kind	kInt
kinder	kIndR
kirchturm	kirctUrm
kirschen	kIrSN
kissen	kIsN
kitzbühl	kITbyl
kitzelt	kITElt
klappert	klApRt
klar	klAr
klatsche	klAC@
klaus	kl3s
kleben	klebN
klebrig	klebrIc
klebt	klept
klecker	klEkR
kleckert	klEkRt
klee	kle
kleid	kl1t
klein	kl1n
kleine	kl1n@
kleinen	kl1nN
kleiner	kl1nR
kleines	kl1n@s
kleingeld	kl1ngElt
kleinnes	kl1n@s
kleinschneiden	kl1nSn1dN
klemmt	klEmt
klettermax	klEtRmAks
klettern	klEtRn
klettert	klEtRt
kletterturm	klEtRtUrm
klötze	klQT@
knacks	knAks
knallt	knAlt
knappen	knApN
knibbelklein	knIbLkl1n
knibbelt	knIbLt
knie	kni
knochen	knOxN
knopf	knOP
knöpfe	knQP@
knöpfen	knQPN
knüpfen	knYPN
koffer	kOfR
kombiniert	kOmbInirt
komisch	komIS
komischen	komISN
komm	kOm
komme	kOm@
kommen	kOmN
kommse	kOmz@
kommst	kOmst
kommt	kOmt
kommunikation	komunIkaTion
konjugiert	kOnjugirt
konnte	kOnt@
konntest	kOnt@st
kontrollieren	kOntrOlirN
kontrolliern	kOntrOlirN
konzept	kOnTEpt
kopf	kOP
kopfkissen	kOPkIsN
kopfverband	kOPferbant
korb	kOrp
kra	kra
krabbel	krAbL
krabbeln	krAbLn
krachmacherei	krAxmAxer1
krachst	krAxst
krakeleien	krakL1N
krakelt	krakLt
krank	krAnk
krankenhaus	krAnkNh3s
kreiden	kr1dN
krieg	kric
kriegen	krigN
kriegst	kricst
kriegt	krict
kroko	krOko
krokodil	krOkodil
kuchen	kuxN
kugeln	kugLn
kuh	ku
kuhstall	kustAl
kurz	kUrT
kuscheln	kUSLn
kutsche	kUtS@
könige	kqnIg@
können	kQnN
könnn	kQnN
könnt	kQnt
könnte	kQnt@
körner	kQrnR
körper	kQrpR
körperlich	kQrpRlIc
körperteile	kQrpRt1l@
küche	kyc@
kücken	kykN
kühe	ky@
kühen	kyN
küsschen	kYscN
lachen	lAxN
lachst	lAxst
lacht	lAxt
laden	ladN
ladungen	ladUngN
laedt	let
laengs	lEncs
laengst	lEncst
laengsten	lEncstN
laesst	lEst
laetzchen	lETcN
laeufst	l2fst
laeuft	l2ft
lampe	lAmp@
lang	lAnc
lange	lAng@
langen	lAngN
langer	lAngR
langsam	lAngzAm
lappen	lApN
lass	lAs
lassen	lAsN
lastauto	lAst3to
laster	lAstR
laterne	lAtern@
laufen	l3fN
laut	l3t
lauter	l3tR
lebte	lept@
leck	lEk
lecken	lEkN
lecker	lEkR
leckt	lEkt
leer	leR
leg	lec
legen	legN
legs	lecs
legst	lecst
legt	lect
leguan	leguan
leiber	l1bR
leicht	l1ct
leider	l1dR
leise	l1z@
leiter	l1tR
leitern	l1tRn
lena	lenA
leopard	leopArt
lesen	lezN
letzte	lETt@
letzten	lETtN
letztes	lETt@s
leut	l2t
leute	l2t@
licht	lIct
lichtlein	lIctl1n
lieb	lip
lieber	libR
liebes	lib@s
lieblingsbuch	liblingsbux
lieblingsfarbe	liblingsfarb@
lied	lit
lieder	lidR
liegen	ligN
liegt	ligt
liese	liz@
liest	list
lila	lila
lina	lina
loch	lox
lokführer	lOkfyrR
los	los
losgefahren	losg@farN
lotsen	lOTN
lotte	lOt@
luft	lUft
luftballon	lUftbAlOn
lustig	lUstIc
lustige	lUstIg@
lustigen	lUstIgN
lustiger	lUstIgR
lustiges	lUstIg@s
löffel	lQfL
löffeln	lQfLn
löschen	lqSN
löwe	lqv@
löwen	lqvN
löwenmutter	lqvNmUtR
löwin	lqvIn
mach	mAx
mache	mAx@
machen	mAxN
machens	mAxNs
machs	mAxs
machst	mAxst
machstn	mAxstN
macht	mAxt
machte	mAxt@
machtn	mAxtN
machts	mAxts
maedchen	medcN
maeh	me
maehne	men@
maenner	mEnR
maennlein	mEnl1n
maeuschen	m2scN
maeuse	m2z@
maeuselchen	m2zLcN
maeusen	m2zN
mag	mAc
magst	mAcst
mahl	mal
maiburg	m1bUrc
mal	mAl
malblock	malblOk
malen	malN
maler	malR
malkunst	malkUnst
maln	malN
malst	malst
malstifte	malStIft@
malt	malt
mama	mAmA
mami	mAmi
mamis	mAmis
mammi	mAmi
mammis	Aamis
man	mAn
manches	mAnc@s
manchmal	mAncmAl
manipuliert	mAnIpulirt
mann	mAn
mantel	mAntL
marabu	mArAbu
marianne	mAriAn@
marie	mAri
marienkaefer	mAriNkefR
mark	mArk
markt	mArkt
markus	mArkus
markuss	mArkus
marmelade	mArm@lad@
maus	m3s
medizin	mEdITin
mehr	mer
meim	m1n
mein	m1n
meine	m1n@
meinem	m1nM
meinen	m1nN
meiner	m1nR
meins	m1ns
meinst	m1nst
meinste	m1nst@
meint	m1nt
meistems	m1stNs
meister	m1stR
melkt	mElkt
menge	mEng@
mensch	mEnS
menschen	mEnSN
meppo	mEpo
merken	merkN
merkst	merkst
messer	mEsR
metzger	mETgR
miau	mI3
mich	mIc
michi	mici
milch	mIlc
mineralwasserflasche	mInEralvAsRflAS@
mir	mir
mist	mIst
mit	mIt
mitgebracht	mItg@brAxt
mitgefahren	mItg@farN
mitgefahrn	mItg@farN
mitgenomm	mItg@nOmN
mitgewesen	mItg@vezN
mitkomm	mItkOmN
mitkommen	mItkOmN
mitm	mItm
mitnehm	mItnem
mitnehmen	mItnemN
mitspielen	mItSpilN
mittag	mItAc
mitten	mItN
mittlerweile	mItlRv1l@
modernen	modernN
mohrrübe	moryb@
mohrrüben	morybN
mohrrübensaft	morybNzAft
moment	momEnt
mond	mOnt
morgen	mOrgN
morgens	mOrgNs
moritz	morIT
motorrad	motorAt
mumpsbacken	mUmpsbakN
mund	mUnt
mundharmonika	mUnthArmonikA
munter	mUntR
musik	muzik
muss	mUs
musst	mUst
musste	mUst@
mussten	mUstN
musstes	mUst@s
mutter	mUtR
mutters	mUtRs
myrthe	myrt@
myrthes	myrt@s
möbel	mqbL
möcht	mQxt
möchte	mQxt@
möchtest	mQxt@st
möglich	mQglIc
müde	myd@
müder	mydR
mühelos	my@los
mühle	myl@
müll	mYl
müsli	mysli
müssen	mYsN
müssn	mYsN
müsst	mYst
müsste	mYst@
mütze	mYT@
n	N
na	nA
nach	nAx
nachgesagt	nAxg@zagt
nachher	nAxher
nachmachen	nAxmAxN
nachrichten	nAxrIctN
nachsagt	nAxzagt
nacht	nAxt
nackdei	nAkd1
nackedei	nAk@d1
nackig	nAkIc
nadel	nadL
naechste	nEcst@
naechstes	nEcst@s
naegel	negL
naeh	ne
naehen	neN
naeherst	neRst
naemlich	nemlIc
naja	nAjA
namen	namN
nani	nani
nase	naz@
nasenloch	nazNlox
naseputzen	naz@puTN
nashorn	nAshorn
nashörner	nAshQrnR
nashörnern	nAshQrnRn
nass	nAs
nasse	nAs@
nassen	nAsN
nassgespritzt	nAsg@SprITt
natürlich	nAtyrlIc
ne	n@
neben	nebN
nebenbei	nebMb1
nee	ne
nehm	nem
nehme	nem@
nehmen	nemN
nein	n1n
nena	nena
nenas	nenas
nennt	nEnt
nesa	nezA
nest	nEst
nette	nEt@
neu	n2
neue	n2@
neuen	n2N
neuer	n2R
neuerdings	n2Rdings
neues	n2@s
neulich	n2lIc
neun	n2n
neunten	n2ntN
neunundzwanzigster	n2nundTvanTIgstR
neunzehnhundertachtundachzig	n2nTenhundertaxtuntaxTIc
neunzehnte	n2nTent@
neunzehnten	n2nTentN
neunzehnter	n2nTentR
neustem	n2stM
nicht	nIct
nichts	nIcts
nicki	nIki
nie	ni
niemand	nimAnt
nilpferd	nIlPert
nimm	nIm
nimmst	nImst
ning	nInc
nippel	nIpL
nix	nIx
noch	nOx
nochmal	nOxmAl
nochn	nOxN
normale	nOrmAl@
november	nofEmbR
null	nul
nun	nUn
nur	nur
nussschokolade	nusSokolAd@
nö	nq
ob	Op
oben	obN
objekt	OpjEkt
objekte	OpjEkt@
objekten	OpjEktN
objektnamen	OpjektnamN
obst	Opst
obwohl	Opvol
och	Ox
oder	odR
ofen	ofN
offen	OfN
oft	Oft
oh	o
ohne	on@
ohr	Or
ohren	OrN
oktober	OktobR
olympiamünze	OlympiamynT@
omi	omI
orange	orAnJ@
ordnung	OrdnUnc
otto	Oto
paar	par
pack	pAk
packen	pAkN
packst	pAkst
packt	pAkt
palme	pAlm@
pampelmuse	pAmpLmuz@
papi	pApi
papier	pApir
papis	pApis
pappi	pApi
pappis	pApis
parfum	pArfum
pass	pAs
passen	pAsN
passieren	pAsirN
passiert	pAsirt
passsiert	pAsirt
passt	pAst
pelikan	pElIkAn
perlchen	perlxN
perlen	perlN
perlenkette	perlNkEt@
pfau	P3
pfeife	P1f@
pfeift	P1ft
pferd	Pert
pferdchen	PertcN
pferde	Perd@
pferden	PerdN
pflaster	PlAstR
pflaume	Pl3m@
pflaumen	Pl3mN
pflaumenstein	Pl3mNSt1n
pflücken	PlYkN
phantasie	fAntAzi
pickst	pikst
piekst	pikst
pieps	pips
pietz	piT
pilot	pilot
pilz	pIlT
pimmchen	pImcN
pimpchen	pImpcN
pimpelchen	pImpLcN
plabbert	plAbRt
plaetze	plET@
platsch	plAC
platt	plAt
platz	plaT
plfaumenstein	Pl3mNst1n
plumpplurie	plUmpluri
plötzlich	plQTlIc
po	po
poh	po
pony	poni
ponys	ponis
popeln	popLn
popo	popo
positive	pOzItif@
post	pOst
postkarte	pOstkArt@
prag	prac
prima	primA
pritscheln	prICLn
probier	probir
probieren	probirN
probiern	probirN
probiers	probirs
probiert	probirt
produziert	prOduTirt
prozedur	proTedur
pru	pru
pröstchen	prqstcN
puck	pUk
pulli	pUli
pullover	pUlofR
puma	puma
puppe	pUp@
purzelbaum	pUrTLb3m
pusten	pustN
pustet	pust@t
putz	pUT
putzen	pUTN
puzzel	pUTTL
puzzle	pUTTl@
pünktchen	pYnktcN
püppchen	pYpcN
quackel	kvAkL
quak	kvak
quasi	kvazI
quatscht	kvACt
quieckt	kvikt
qürgemalten	kverg@maltN
rabs	rAps
raeuber	r2bR
raeuberhauptmann	r2bRh3ptmAn
raeum	r2m
raeumlichen	r2mlIcN
raeumst	r2mst
raeumt	r2mt
rand	rAnt
ranzukommen	rAnTukOmN
raps	rAps
rasenmaeher	razNmeR
raubtier	r3btir
rauf	r3f
raufgefahrn	r3fg@farN
raufgehen	r3fgeN
raufgeklettert	r3fg@kl3tRt
raufklettern	r3fklEtRn
raum	r3m
raupe	r3p@
raupen	r3pN
raus	r3s
rausbrechen	r3sbrEcN
rauschenden	r3SEndN
rauschleudern	r3Sl2dRn
rausgefallen	r3sg@fAlN
rausgehen	r3sgeN
rausgeklettert	r3sg@klEtRt
rausgekomm	r3sg@kOm
rausgekommen	r3sg@kOmN
rausgemolken	r3sg@mOlkN
rausguckt	r3sgUkt
rausholem	r3sholN
rausholen	r3sholN
rauskommen	r3skOmN
rausmachen	r3smAxN
rausnehmen	r3snemN
rauss	r3s
raussgefallen	r3sg@fAlN
raustun	r3stun
reaktionen	reAkTionN
recht	rEct
rede	red@
reden	redN
regal	regal
regalchen	regalcN
regen	regN
regnete	regn@t@
reh	re
reicht	r1ct
reif	r1f
reihe	r1@
reihenfolgen	r1NfolgN
rein	r1n
reindrücken	r1ndrykN
reinfangen	r1nfAngN
reingehopst	r1ng@hOpst
reingeregnet	r1ng@regn@t
reingesprungen	r1ng@SprUngN
reingetan	r1ng@tan
reingucken	r1ngUkN
reinsteigen	r1nSt1gN
reintun	r1ntun
reissverschluss	r1sferSlus
reiten	r1tN
reiter	r1tR
reserve	rezerf@
richtig	rIctIc
richtige	rIctIg@
richtigen	rIctIgN
richtiger	rIctIgR
richtiges	rIctIg@s
riechen	ricN
riechst	ricst
riecht	rict
riesenweib	rizenv1p
ring	rinc
ringkampf	ringkAmP
ritz	rIT
robben	rObN
rollen	rOlN
roller	rOlR
rollt	rOlt
rot	rot
rote	rot@
roten	rotN
roter	rotR
rotes	rot@s
rubbel	rUbL
rubbeln	rUbLn
ruberto	ruberto
rucksack	rukzak
rufen	rufN
rufst	rufst
ruhe	ru@
ruhig	ruIc
rum	rum
rumlaufen	ruml3fN
rummattern	rummAtRn
rumpopeln	rumpopLn
rumsausen	rumz3zN
rumschmeissen	rumSm1sN
rumschmiern	rumSmirn
rumschmierst	rumSmirst
rumschmiert	rumSmirt
rumzisseln	rumTIsLn
rumzumachen	rumTumAxN
rund	rUnt
runter	rUntR
runteressen	rUntREsN
runterfaellst	rUntRfElst
runterfaellt	rUntRfElt
runtergefallen	rUntRg@fAlN
runtergefalln	rUntRg@fAln
runtergenommen	rUntRg@nOmN
runterkommen	rUntRkOmN
runterschmeissen	rUntRSm1sN
ruperto	ruberto
rupfen	rUPN
russland	ruslant
rutsch	ruC
rutsche	rutS@
rutschen	rutSN
rübe	ryb@
rübersteichen	rybRSt1cN
rücken	rYkN
rüssel	rYsL
rüstung	rYstUnc
sache	zAx@
sachen	zAxN
saecke	zEk@
saege	zeg@
saegewerk	zeg@verk
saengerin	zEngRIn
saetze	zET@
saeule	z2l@
saft	zAft
sag	zac
sage	zag@
sagen	zagN
sager	zagR
sagst	zacst
sagt	zagt
sagte	zagt@
sagtn	zagtN
sah	za
salamader	zAlAmandR
salamander	zAlAmandR
salat	zAlat
salatsouce	zAlatzos@
salbe	zAlb@
salto	zAlto
sammeln	zAmLn
samt	zAmt
sand	zAnt
sandalen	zAndalN
sandro	zAndro
sani	zani
satt	zAt
sauber	z3bR
saubermachen	z3bRmAxN
sauer	z3R
sauerei	zyr1
saus	z3s
sausen	z3zN
saust	z3st
schachtel	SAxtL
schade	Sad@
schaefchen	SefcN
schaetzchen	SETcN
schaf	Saf
schafe	Saf@
schafen	SafN
scharf	SArf
schatz	SAT
schau	S3
schauen	S3N
schaufel	S3fL
schaufeln	S3fLn
schaukel	S3kL
schaukelpferd	S3kLPert
schaukelt	S3kLt
schaun	S3N
schaut	S3t
scheint	S1nt
schenk	SEnk
schenken	SEnkN
schenkst	SEnkst
schere	Ser@
scheunentor	S2nNtor
scheusslich	S2slIc
schick	SIk
schicken	SIkN
schickt	SIkt
schieben	SibN
schiebt	Sipt
schief	Sif
schier	Sir
schiet	Sit
schietchen	SitcN
schiff	SIf
schiffchen	SIfcN
schiffe	SIf@
schildkröte	SIltkrqt@
schildkröten	SIltkrqtN
schimpfst	SImPst
schirme	SIrm@
schlaefchen	SlefcN
schlaefst	Slefst
schlaeft	Sleft
schlaf	Slaf
schlafanzug	SlafAnTuc
schlafen	SlafN
schlafzimmer	SlafTImR
schlange	SlAng@
schlecht	SlEct
schlechte	SlEct@
schleife	Sl1f@
schleifen	Sl1fN
schlimm	SlIm
schlimmes	SlIm@s
schluss	SlUs
schlüssel	SlYsL
schmarren	SmArN
schmeckt	SmEkt
schmeiss	Sm1s
schmeissen	Sm1sN
schmeisst	Sm1st
schmetterling	SmEtRlinc
schmetterlinge	SmEtRling@
schmier	Smir
schmiererei	SmirR1
schmiern	Smirn
schmiers	Smirs
schmierst	Smirst
schmiert	Smirt
schmuck	SmUk
schmuckstück	SmUkstYk
schmusemaus	Smuz@m3s
schmutzwaesche	SmUTvES@
schnabel	SnabL
schnappen	SnApN
schnapsideen	SnApsideN
schnatterliese	SnAtRliz@
schnattern	SnAtRn
schnecke	SnEk@
schnecken	SnEkN
schneckenpost	SnEkNpOst
schnee	Sne
schneid	Sn1t
schneiden	Sn1dN
schnell	SnEl
schnibbel	SnIbL
schnibbelchen	SnIbLcN
schnuller	SnUlR
schnupfen	SnUPN
schnuppen	SnUpN
schnöbbel	SnQbL
schnöbbelbraten	SnQbLbratN
schnöbbelchen	SnQbLcN
schnöbbelhase	SnQbLhaz@
schnöbbelmaus	SnQbLm3s
schnön	Sqn
schokolade	SokolAd@
schokoladenjoghurt	SokolAdNjogurt
scholli	SOli
schon	Son
schoss	SOs
schrank	SrAnk
schreck	SrEk
schreibtisch	Sr1btIS
schreien	Sr1N
schreitn	Sr1tN
schriftzeichen	SrIfT1cN
schritte	SrIt@
schub	SUp
schubbern	SUbRn
schublade	SUplad@
schubst	SUpst
schuh	Su
schuhe	Su@
schuppsen	SUpzN
schuppst	SUpst
schwabt	Svapt
schwackelschwanz	SvAkLSvAnT
schwan	Svan
schwanz	SvAnT
schwappt	SvApt
schwarz	SvArT
schwarze	SvArT@
schwarzen	SvArTN
schwarzes	SvArT@s
schweigen	Sv1gN
schwein	Sv1n
schweine	Sv1n@
schweinen	Sv1nN
schweinerei	Sv1nR1
schwer	SvR
schwimm	SvIm
schwimmbad	SvImbAt
schwimmbadbild	SvImbAtbIlt
schwimmbadbuch	SvImbAtbux
schwimmen	SvImN
schwimmt	SvImt
schöbbelchen	SnQbLcN
schön	Sqn
schöne	Sqn@
schönen	SqnN
schönes	Sqn@s
schürze	SYrT@
schüttelst	SYtLst
schüttelt	SYtLt
sebastian	zebAstiAn
sechs	zeks
sechshundert	zekshundRt
sechster	zEcstR
sechzehnter	zeksTentR
see	ze
seehunde	zehUnd@
seehunden	zehUndN
segen	zegN
seh	ze
sehen	zeN
sehn	zeN
sehr	zer
sei	z1
seid	z1t
seife	z1f@
seifenblasen	z1fNblazN
seim	z1m
sein	z1n
seine	z1n@
seinem	z1nM
seinen	z1nN
seiner	z1nR
seit	z1t
seite	z1t@
seiten	z1tN
selber	zElbR
selbst	zElbst
september	zEptEmbR
setz	zET
setzen	zETN
setzt	zETt
setzte	zETt@
sibirien	zIbiriN
sich	zIc
sicher	zIcR
sicherheit	zIcRh1t
sie	zi
sieben	zibN
siebte	zibt@
siehst	zist
siehstn	zistN
sieht	zit
sies	zis
simon	zImon
sind	zInt
sing	zInc
singen	zIngN
singn	zIngN
singst	zIncst
singt	zIngt
sinne	zIn@
situationen	zItuaTiOnN
sitz	zIT
sitzen	zITN
sitzt	zITt
sitztn	zITtN
so	zo
socken	zOkN
sofort	zofOrt
sogar	zogAr
solange	zolang@
solche	zOlc@
solchen	zOlcN
soll	zOl
sollen	zOlN
solln	zOlN
solls	zOls
sollst	zOlst
sollt	zOlt
som	zom
sondern	zOndRn
sone	zon@
sonne	zOn@
sonnenblumenkern	zOnNblumNkern
sonst	zOnst
sonsten	zOnstN
sophie	zofi
sowas	zovas
sowieso	zovizo
sozialen	zOTiAlN
spaeter	SpetR
spazieren	SpATirN
spaziergang	SpATirgAnc
spiegel	SpigL
spiel	Spil
spiele	Spil@
spielen	SpilN
spieln	SpilN
spielplatz	SpilplAT
spielsachen	SpilzAxN
spielt	Spilt
spinne	SpIn@
spitz	SpIT
spitze	SpIT@
sprechen	SprEcN
springen	SprIngN
springt	SprIngt
spritz	SprIT
spucke	SpUk@
spulen	SpulN
stadt	StAt
staerker	SterkR
stall	stAl
stand	StAnt
stark	StArk
staub	St3p
stechen	StEcN
steck	StEk
steckdosen	StEkdozN
stecken	StEkN
steckspiel	StEkSpil
steckt	StEkt
steh	St@
stehen	SteN
stehn	StN
stehst	Stest
steht	Stet
steig	St1c
steigen	St1gN
steigt	St1gt
stein	St1n
steine	St1n@
stell	StEl
stelle	StEl@
stellen	StElN
stelln	StElN
stellst	StElst
stellt	StElt
sterne	Stern@
sticht	StIct
stiefeln	StifLn
stift	StIft
stifte	StIft@
stimmt	StImt
stinkhose	StInkhoz@
stinkmüll	StInkmyl
stinkt	StInkt
stoffhasen	StOfhazN
storch	StOrc
storchenelternpaar	StOrcNEltRnpar
strasse	StrAs@
strassenbau	StrAsNb3
streicheln	Str1cLn
streichelt	Str1cLt
streichen	Str1cN
streiten	Str1tN
stricknadel	StrIknadL
strickzeug	StrIkT2c
strumpf	StrUmP
strumpfhose	StrUmPhoz@
strumpfhosen	StrUmPhozN
strümpfe	StrYmP@
stuhl	Stul
stuss	StUs
störche	Stqrc@
stösst	Stqst
stück	StYk
stückchen	StYkcN
stühlchen	StylcN
stühle	Styl@
suabermachen	z3bRmAxN
such	zux
suche	zux@
suchen	zuxN
suchst	zuxst
sucht	zuxt
susanne	zuzan@
söckchen	zQkcN
süden	zydN
süss	zys
süsse	zys@
süsses	zys@s
ta	ta
tage	tag@
tagen	tagN
tante	tAnt@
tanten	tAntN
tanze	tAnT@
tanzen	tAnTN
tanzt	tAnTt
tapfer	tAPR
tapp	tAp
tasche	tAS@
taschentuch	tASNtUx
tasse	tAs@
tatsache	tAtzAx@
taucht	t3xt
tausendneunzig	t3zNtn2nTIc
tausendsten	t3zEntstN
teddybaer	tEdiber
tee	te
teich	t1c
teile	t1l@
telefon	tel@fon
telefoniert	tel@fOnirt
teller	tElR
teppich	tEpIc
terrortyp	tErortYp
tesafilm	tezAfIlm
teufel	t2fL
teufelchen	t2fLcN
teufli	t2fli
thomas	tomAs
tiefen	tifN
tier	tir
tierbilderbuch	tirbIldRbux
tiere	tir@
tieren	tirN
tierlaute	tirl3t@
tiern	tirN
tiger	tigR
tim	tIm
timpetu	tImpetu
tisch	tIS
tobt	topt
toll	tOl
tolle	tOl@
tollen	tOlN
toller	tOlR
tolles	tOl@s
tomate	tomAt@
tomaten	tomAtN
ton	ton
tonband	tonbAnt
topf	tOP
tor	tor
torkelig	tOrkLIc
tot	tot
total	tOtal
trampeln	trAmpLn
traurig	tr3rIc
trecker	trEkR
trekker	trEkR
trennung	trEnUnc
treppe	trEp@
treten	tretN
trink	trInk
trinken	trInkN
trinkt	trInkt
triumph	triUmf
triumphiert	triUmfirt
trocknet	trOkn@t
trotzdem	trOTdem
trotzphase	trOTfaz@
tschüss	CYs
tu	tu
tun	tun
turm	turm
turner	turnR
turnt	turnt
tus	tus
tust	tust
tut	tut
tutenchamun	tutNcamun
typen	tYpN
töne	tqn@
tücher	tyChR
tür	tyr
tüte	tyt@
uhr	ur
uhren	urN
uhu	uhu
um	um
umblaettern	umblEtRn
umdrehen	umdreN
umfaellst	umfElst
umfaellt	umfElt
umgedreht	umg@dret
umgefallen	umg@falN
umgefalln	umg@falN
umgehaengt	umg@hEngt
umgeschmissen	umg@SmIsN
umgestellt	umg@stElt
umhin	umhIn
umkippen	umkIpN
ummachen	ummAxN
umschmeissen	umSm1sN
umsonst	umzOnst
unbedingt	unb@dIngt
und	Unt
unfall	UnfAl
ungeduldig	ung@duldIc
ungefaehr	ung@fer
unheimlich	nh1mlIc
uni	uni
uns	Uns
unser	UnzR
unsere	UnzR@
unserm	UnzRM
unsre	UnsR@
unten	UntN
unter	UntR
untergetaucht	UntRg@t3xt
unterm	UntRM
unternehmungen	UntRnemUngN
unterschied	UntRSit
unterwegs	UntRvecs
ute	ut@
utemarie	ut@mAri
verband	ferbAnt
verbrannt	ferbrAnt
verdacht	ferdAxt
verfüngliches	ferfynglIc@s
vergessen	fergEsN
verklemmt	ferklEmt
verlangt	ferlAngt
verliern	ferlirN
verloren	ferlorN
verpasst	ferpAst
verputzt	ferpUTt
verrückt	ferYkt
verschiedenen	ferSidNN
verschlingt	ferSlIngt
verschluckst	ferSlUkst
verschwindet	ferSvInd@t
versehen	ferzeN
versprochen	ferSprOxN
verstaut	ferSt3t
versteckt	ferStEkt
versteh	ferSt@
verstehen	ferSteN
versteht	ferStet
verstreichen	ferStr1cN
versuch	ferzux
versuchen	ferzuxN
versuchs	ferzuxs
versucht	ferzuxt
verwendet	fervEnd@t
viel	fil
viele	fil@
vielen	filN
vieles	fil@s
vielleicht	fil1ct
vier	fir
vierte	firt@
vierzehnter	firTentR
vitam	fItam
vitambrot	fItambrot
vogel	fogL
voll	fOl
vollgemalt	fOlg@malt
vom	fOm
von	fOn
vor	fOr
vorach	fOrax
vorbei	fOrb1
vorher	fOrher
vorhin	fOrhIn
vorichtig	forIctIc
vorischt	forzIct
vorlesen	fOrlezN
vorne	fOrn@
vorsicht	fOrzIct
vorsichtig	fOrzIctIc
vorwaerts	fOrverts
vögel	fqgL
vögelchen	fqgLcN
völlig	fQlIc
wach	vAx
wacht	vAxt
wackelnschwanz	vAkLSvAnT
wackelschwanz	vAkLSvAnT
waer	ver
waerter	vertR
waesche	vES@
wagen	vAgN
waggons	vAgons
wahnsinn	vanzIn
wahnsinnger	vanzIngR
wahnsinnig	vanzInIc
wald	vAlt
waltraut	vAltr3t
wan	vAn
wand	vAnt
wann	vAn
war	vAr
ward	vArt
waren	varN
warm	vArm
warn	vArn
wars	vArs
warst	vArst
wart	vArt
warte	vArt@
warten	vArtN
wartet	vArt@t
warum	vArum
was	vAs
waschen	vASN
waschlappen	vASlApN
waschmaschine	vASmASIn@
wasn	vAsN
wasser	vAsR
wasserblasen	vAsRblAzN
watte	vAt@
weberknecht	vebRknect
wecken	vEkN
weg	vEc
wegbringen	vEcbrIngN
weggefahren	vEcg@farN
weggeflogen	vEcg@flogN
weggegangen	vEcg@gAngN
weggehen	vEcgeN
weggelaufen	vEcg@l3fN
weggenommen	vEcg@nOmN
weggeraeumt	vEcg@r2mt
weggeschmissen	vEcg@SmIsN
weglegen	vEclegN
wegnehme	vEcnem@
wegschmeissen	vEcSm1sN
weh	ve
wehgetan	veg@tAn
wehtun	vetun
wehtut	vetut
wei	v1
weihnachtsbaum	v1nAxtsb3m
weil	v1l
weils	v1ls
weinen	v1nN
weint	v1nt
weise	v1z@
weiss	v1s
weisse	v1s@
weissen	v1sN
weisser	v1sR
weisst	v1st
weit	v1t
weiter	v1tR
weiterblaettern	v1tRblEtRn
weitere	v1tR@
weiteressen	v1tREsN
weitergehen	v1tRgeN
weitergucken	v1tRgUkN
weiterhin	v1tRhIn
weiterrutsch	v1tRrUC
welch	vElc
welche	vElc@
welchen	vElcN
welcher	vElcR
welches	vElc@s
welsch	vElS
wem	vem
wen	ven
wenig	venIc
weniger	venIgR
wenn	vEn
wenns	vEns
wenzel	vEnTL
wer	ver
werd	vert
werden	verdN
werdn	verdN
werfen	verfN
wespe	vEsp@
wespen	vEspN
wichtel	vIctL
wichtelhausen	vIctLh3zN
wichtelmaennern	vIctLmEnRn
wichtelmann	vIctLmAn
wichtig	vIctIc
wickeln	vIkLn
wie	vi
wieder	vidR
wiederentdeckt	vidREntdEkt
wiederkomm	vidRkOm
wiese	viz@
wiesen	vizN
wieso	vizo
wieviel	vifil
wieviele	vifil@
wievielten	vifiltN
wild	vIlt
will	vIl
willi	vIli
willst	vIlst
wimer	vimR
windel	vIndL
winke	vInk@
winken	vInkN
winkt	vInkt
winter	vIntR
wir	vir
wird	virt
wirf	virf
wirklch	virklIc
wirklich	vIrklIc
wirst	virst
wisch	vIS
wischt	vISt
wissen	vIsN
wisst	vIst
witzig	vITIc
witzigerweise	vITIgRv1z@
wo	vo
wobei	vob1
woche	vOx@
wochen	vOxN
wohl	vol
wohnen	vonN
wohnt	vont
wohnungen	vonUngN
wohnwagen	vonvAgN
wolf	vOlf
woll	vOl
wollen	vOlN
wollst	vOlst
wollt	vOlt
wollte	vOlt@
wollten	vOltN
wolltest	vOlt@st
wort	vOrt
wortaeusserung	vOrt2serUnc
worte	vOrt@
wortstellungsvarianten	vOrtStElUngsfarIantN
wos	vos
wumm	vUm
wund	vUnt
wurm	vUrm
wurst	vUrst
wurstbrot	vUrstbrot
wölfe	vQlf@
wörter	vQrtR
wühlen	vylN
yang	yAnc
zack	TAk
zaehl	Tel
zaehlen	TelN
zaehne	Ten@
zaehnen	TenN
zahn	Tan
zebra	TebrA
zebras	TebrAs
zeh	Te
zehnmarkstück	TenmArkstYk
zeichnet	T1cn@t
zeig	T1c
zeigen	T1gN
zeigt	T1gt
zeigte	T1gt@
zeit	T1t
zeitliche	T1tlIc@
zeitung	T1tUnc
zelt	TElt
zerknickelt	TerknIkLt
zerpflückt	TerPlYkt
zerrissen	TerIsN
zettel	TEtL
zeug	T2c
ziege	Tig@
ziegen	TigN
ziegenböckchen	TigNbqkcN
zieh	Ti
ziehen	TiN
ziehn	TiN
ziehst	Tist
zieht	Tit
zielt	Tilt
ziemlich	TimlIc
ziemliche	TimlIc@
zimmer	TImR
zirkus	TIrkus
zoo	To
zora	TOra
zotteldinger	TOtLdIngR
zu	Tu
zuerst	Tuerst
zug	Tuc
zugeleimt	Tug@l1mt
zugemacht	Tug@mAxt
zugeschaut	Tug@S3t
zugucken	TugUkN
zum	Tum
zumachen	TumAxN
zumindest	TumInd@st
zunge	TUng@
zupfen	TUPN
zur	Tur
zurück	TurYk
zusamm	TuzAmN
zusammen	TuzAmN
zusammenmachen	TuzAmNmAxN
zusammgekracht	TuzAmg@kraxt
zuschnappen	TuSnApN
zuviel	Tufil
zwack	TvAk
zwanzigster	TvAnTIgstR
zwar	TvAr
zwei	Tv1
zweien	Tv1N
zweite	Tv1t@
zweiten	Tv1tN
zwerg	Tverc
zwick	TvIk
zwieback	TvibAk
zwiebeln	TvibLn
zwischendurch	TvISNdurc
zögern	TqgRn
öfters	qftRs
über	ybR
überall	ybRAl
überhaupt	ybRh3pt
übrigen	ybrIgN
übrigens	ybrIgNs
üpfen	yPN
