1	゗
1c	䀸
1n	も
1ns	ゃ
1s	㙤
2	㌨
2c	㥁
2s	䁆
3	ざ
3f	ㄩ
3fs	䍦
3s	㉠
3ss	䔷
3x	㉢
@	ㅧ
@s	㕐
A	〦
Ad	䍖
Af	䅢
Ak	㐀
Al	㐗
Als	䁹
Alt	ㄈ
Am	㈴
An	〄
Anc	䕸
Ancst	䎕
Ans	䎈
Ant	㑅
Ap	㙃
Ar	㊃
Arm	䄅
Art	㜧
Axt	䘐
C@	䔵
CA	㈧
CLn	㤦
CYs	㑠
ChIC	㙅
ChR	㊒
Chim	䔩
E	ㄵ
Eks	䌴
El	㜁
En	㊖
Enc	㠖
Ent	㈉
Er	㌇
Erd	㜸
Es	ㄧ
Et	㍤
I	ㅣ
IS	㜩
Ic	〥
Im	㊁
In	㄃
Ins	㐓
Ir	㐇
Is	䉩
Ist	べ
J@	䅐
JEnt	䀵
JI	㜄
Ju	㑐
L	䀨
Ln	䆃
M	㦂
N	じ
Ns	䒐
O	㌦
Oft	㖇
Ok	㈸
Op	㒓
Opst	䁒
Or	䀴
Ord	䊆
Os	㜈
Ox	䒘
P1	㝐
P1ft	䑡
P3	䙰
P@	㠨
PI	㚄
PIc	㚃
PL	㘖
PN	㠃
PR	䖖
Per	㌹
Pert	㊈
Pl3	䍢
PlA	䕧
PlY	䙤
PlYkt	ㄗ
R	と
Rn	㤖
Rst	㡰
Rt	䅴
S1nt	䈆
S2	䔀
S2s	䌲
S3	ど
S3n	ㅇ
S3t	㊗
S@	゙
S@s	䅤
SAT	㈥
SAf	䀂
SAr	㘦
SArf	䖅
SAx	ㄓ
SE	㑷
SET	䔸
SEn	㝕
SEnk	㑖
SEnkst	䐘
SEnkt	䉵
SI	䄒
SIc	㡶
SIf	㤤
SIk	䈦
SIkt	䀀
SIlt	㢘
SImPst	ㅨ
SImPt	䙹
SIr	䙁
SLn	䙅
SN	ㄅ
SO	䊖
SOs	䍘
SU	㉩
SUp	㔹
SUpst	䁴
SY	㎖
SYr	㡠
Sa	㜤
Saf	㖕
Sar	䎙
Se	䍧
Sef	䘦
Si	㢐
Sif	㕡
Sipt	ㆆ
Sir	㙇
Sit	㜣
Sl1	䕹
Sl2	㖅
SlA	㤧
SlAn	䁂
SlEc	䍡
SlEct	䀉
SlI	䅩
SlIm	䔈
SlIngt	䌉
SlUkst	㙕
SlUs	䀘
SlYs	䄆
Sla	ㆀ
Slaf	㐲
Slef	㘕
Slefst	㥂
Sleft	㌢
Slis	㑆
Slus	䐧
Sm1	ㆈ
Sm1s	㈡
Sm1st	䍙
SmA	㢀
SmE	㝈
SmEkt	䉡
SmIs	㚙
SmU	䄩
SmUk	䄂
Smi	䌀
Smir	䉆
Smirn	䒗
Smirs	䎇
Smirst	䈹
Smirt	㡧
Smu	㉨
Sn1	䎃
Sn1t	䈵
SnA	䄘
SnAps	䁧
SnE	㡆
SnEl	㝵
SnI	䀢
SnQ	〸
SnU	㈇
Sna	䁁
Sne	䅘
So	䌠
Son	〒
SpA	䐈
SpAn	䐖
SpI	䄄
SpIT	㍱
SpU	䘃
Spe	䄲
Spert	䎗
Spi	㤰
Spil	つ
Spilt	ち
SprE	㜹
SprI	䔔
SprIT	䒄
SprITt	䈥
SprIn	䂔
SprIngt	䁢
SprOx	䕶
SprUn	䅇
Spu	㈲
Sq	㦐
Sqn	㈦
Sr1	㘃
Sr1b	㡓
Sr3	㢒
SrAk	䘆
SrAnk	㐘
SrE	䕤
SrEk	䌨
SrI	䐣
SrIf	䐄
Sri	䅄
St1	㔄
St1c	䂈
St1gt	䂉
St1n	䍠
St3p	㥹
St3t	㉴
St@	䅥
StAnt	䍴
StArk	㒉
StAt	䔣
StE	㘓
StEk	っ
StEkt	㡡
StEl	㠒
StElst	䕂
StElt	〰
StEn	䊅
StIct	䕴
StIf	㢃
StIft	㊉
StImt	㌴
StInk	䄐
StInkt	㡇
StN	䔄
StOf	㕓
StOr	䘶
StOrc	䁃
StOx	䑅
StUs	䐩
StYk	䈸
Stap	䒒
Ste	㎑
Ster	㐤
Stest	、
Stet	ぅ
Sti	㔓
Stqr	䘰
Stqst	䍷
Str1	㝦
StrAs	䅠
StrEn	ㅂ
StrI	㍲
StrIk	㍨
StrUmP	㠇
StrYm	㠧
Stul	㎂
Sty	㚉
Styl	㚇
Su	㌡
Sv1	䈅
Sv1n	㖒
SvA	䘲
SvAnT	䐤
SvApt	䒈
SvAr	㢁
SvArT	䀓
SvI	㤇
SvIm	䄥
SvImt	㝴
SvIn	䉠
SvO	䅅
SvOm	䘂
SvR	㍢
Svan	䄣
Svapt	䑀
T1	㕖
T1c	㉧
T1g	䁓
T1gt	㕕
T1t	㑩
T2	䄦
T2c	㍩
T@	㌲
T@s	㢂
TAk	㑓
TAnkt	㤀
TE	䅃
TEl	㕃
TElt	㥃
TEpt	䁱
TI	㐳
TIc	㌗
TIg	䀥
TIr	䆓
TIs	䆂
TL	㥗
TLt	䄷
TN	〗
TO	㌀
TR	䄨
TRn	㝘
TU	䘴
TUn	㒀
TUnc	㥀
TYn	䔑
Takt	㍵
Tan	㤨
Te	ぐ
Tel	㢖
Tels	㘘
Telst	㘡
Telt	㤆
Ten	㈶
Ter	ㄖ
Ti	㈀
Tilt	㑇
Tim	䁦
Tin	㠗
Tir	䐉
Tirt	㥦
Tis	䈧
Tist	䘠
Tit	䄀
To	㊂
Tq	㦃
Tu	ㄸ
Tuc	㉘
Tum	ㅄ
Tur	㍘
Tv1	㌑
TvAk	䕐
TvAn	䈢
TvAr	㡁
TvE	䄰
TvI	㄄
TvIk	䕉
TvIkt	㞐
Tvan	䀤
Tverc	䖔
Tvi	〘
Tvurm	䍆
U	䚁
Um	㐙
Umf	㈓
Un	㍈
Unc	㑳
Uns	㍕
Unt	う
a	ㅵ
an	〷
ar	㕹
b1	㌅
b1m	㈳
b1n	䁘
b1s	㍗
b1st	䄠
b2	㢄
b3	㜰
b3m	㎀
b3mt	䅧
b3r	㘨
b3t	䊗
b3x	㘳
b@	㑰
b@r	䙕
b@rc	㙀
b@s	䙷
bA	㊘
bAk	〙
bAl	㖓
bAlt	䀗
bAm	㥰
bAnk	䒆
bAnt	㔇
bAst	䌷
bAt	䄸
bE	㊕
bElt	㥣
bEnt	㘄
bEs	㈃
bEt	㐔
bI	㉇
bIl	㈱
bIlt	㑕
bIn	㍥
bIs	㌃
bIst	ㅙ
bL	〹
bLn	䑈
bLt	䖉
bM	䁄
bN	㊀
bNt	䖓
bOrt	㔒
bR	ㅶ
bRn	䑒
bRt	䁤
bU	䈩
bUm	䆇
bUn	㎃
bUrc	䘀
bUs	䆘
bYr	䍩
ba	㙸
ban	㉉
bant	䙂
bar	㚁
bat	䘹
bax	㝖
be	㕩
ben	䙣
ber	㙙
berc	䅵
bi	㉕
bin	䖒
bir	䌙
birs	䙇
birt	䅒
bis	㞂
bl1	㠸
bl1p	㤒
bl3	㝑
blA	䊇
blAt	䀇
blE	㎄
blEt	䘳
blIc	㕢
blOk	䍑
blOs	㔆
bla	䊈
bles	䎒
bli	䒕
blings	㉀
blq	䙧
blqt	䐳
blu	䉔
blut	䖆
blym	䐷
bo	䁨
bqk	䙨
br3	䐀
br3n	䀐
br3x	䄈
br3xst	䁩
br3xt	㑂
brA	䘔
brAf	䉐
brAnt	䙒
brAs	䄕
brAxt	䕁
brE	㔐
brEmst	䙡
brEt	䊃
brI	㍖
brIc	䔂
brIn	䀄
brInc	㤄
brIngt	㜠
brQk	㍡
brY	䂁
bra	㡘
bri	㜑
brif	㜃
bro	䉣
brot	䈰
brox	䐅
brq	䉒
brqt	䒇
bu	䁀
bums	䔳
burt	㦒
bux	ㅆ
by	㊑
byc	䎑
byl	䔥
c1	㜐
c@	㊙
c@s	ㅕ
cElt	䀔
cLn	㝧
cLt	䑥
cN	぀
cNt	㝀
cR	㒕
ca	䉶
ci	䐃
d1	を
d1m	䑳
d1n	ぉ
d1ns	䈱
d2	㐢
d3	㘵
d@	ㅡ
d@s	䍣
d@st	㒙
d@t	㒆
dA	〃
dAn	ぶ
dArf	㌐
dArfst	〲
dAs	〱
dAx	㕥
dAxt	㉱
dE	ㄤ
dEkt	㈐
dEn	ㅓ
dEnkst	䉖
dEnkt	ㅷ
dEs	䍶
dEst	䄑
dEt	㙂
dI	㉃
dIc	㍴
dIk	㘴
dIn	㌁
dInc	䈗
dIngs	㚔
dIngt	㕇
dL	㄁
dN	㍓
dO	㕣
dOk	䕣
dOl	㌰
dOx	㈕
dR	〔
dRn	㔥
dRs	䅓
dRt	䅷
dU	㡷
dUm	䍨
dUn	䌇
dUr	㜉
dUrc	㜷
dYn	䐴
dYr	䘥
da	㜲
daxs	䙑
de	㘁
dem	〵
den	【
der	々
di	ぴ
dil	㌸
dings	㐂
dir	㆕
dirs	䐸
dis	䆀
do	㥒
dof	㢆
dr1	㘇
dr3f	ぱ
dr3s	䍀
dr@	䉇
drAn	ㅹ
drE	䀖
drEk	䍐
drI	䂐
drIn	㙴
drR	䅑
drUn	㠕
drY	䀕
dre	㡑
dret	䂖
dro	䑄
druk	㎘
drun	䑆
dry	㚕
dryk	㤓
du	。
dul	䈇
dur	㕳
durc	䕀
e	㒒
en	䙶
er	㆘
erb	㔃
erst	㔔
f1	䑢
f2	䆙
f3nt	䌓
f@	ㅴ
fA	㉶
fAl	㤱
fAln	䐂
fAn	㉹
fAnc	㥶
fAnt	ㅉ
fAs	㥑
fAst	ㄆ
fAx	㈠
fE	䖁
fEl	㠐
fElst	㔅
fElt	䅕
fEm	㌓
fEn	䔕
fEngt	䑓
fEs	し
fEst	㍐
fEt	䎐
fI	㜅
fIS	㌩
fIlm	䑨
fIn	㈘
fL	㎆
fLn	㝇
fN	ㆁ
fO	㥷
fOl	〕
fOm	㐱
fOn	づ
fOr	㈖
fOrt	䅁
fQ	㦗
fR	㤶
fUn	㤅
fUrct	㚀
fY	䑗
fYlt	䑐
fYnf	䁷
fa	㉔
fals	䐢
far	䅈
farb	䐗
fe	㝶
fel	䘕
felt	䍵
fer	〠
fert	㠀
fi	㌘
fil	㎐
fir	㍦
firt	㔉
fl1S	㦇
flA	㑨
flE	㠠
flES	㡖
fli	㤴
fligt	㝲
flo	䒁
flus	䘇
flux	㢓
fo	㍸
fol	䁡
folc	㌈
fon	㊆
for	㘀
fq	㍃
fr1	㥵
fr2	䔱
fr2m	䆔
fr2n	䕘
fr2st	䔦
fr2t	㤡
fr3	㙨
frAgt	䌶
frAxt	㒂
frE	ㅔ
frEc	䄙
frEs	䄖
frI	゘
frIS	䈓
frIT	䘷
frIst	㞁
frOS	㤣
frQ	䘉
frYc	䘈
fra	㜘
fry	㕈
fuks	㌣
fum	㡐
fur	㜳
fus	㍑
fy	䖗
fyn	㡥
fyr	む
fyrn	䈠
fyrs	䈔
fyrt	㐉
fys	䀳
g1	㑱
g1n	㜙
g@	〩
g@p	䌣
g@s	䅔
gAn	〖
gAnT	㍇
gAnc	䐐
gAns	䁇
gAr	䒉
gE	㞄
gEl	㆒
gElp	䁵
gElt	㦁
gEn	㐵
gEnd	㔣
gEnt	㐈
gErn	䕆
gEs	㕷
gIn	㘹
gInc	䘅
gInt	㚅
gIp	㕴
gIps	㑣
gIpst	㑤
gIpt	㘠
gIpts	䎂
gL	㍄
gLn	㝥
gLt	䌗
gN	㌤
gNs	㐰
gNt	ㅃ
gR	㈙
gRn	㦄
gU	㊓
gUk	〢
gUkst	䖇
gUkt	㊐
ga	䅣
gal	㙓
gan	䕨
ganc	䐥
gar	ㅸ
gas	䙵
ge	㐡
gent	䖕
ger	㙈
gest	㑙
get	ㅗ
gets	㉳
gi	䙦
girt	䎓
gl1	㕱
gl1c	㔙
gl3	㙒
gl3p	㙘
glAt	䖂
glI	㡦
glIc	䉴
glInc	䑣
glO	䍄
glQk	䘧
glYk	㕧
glYkt	䑵
glas	䐶
gles	䚆
golt	䎄
gons	㥙
grAt	䁈
grIf	䖀
grUnt	䐨
gras	䍃
gro	㠙
grop	㥢
gros	㉂
grq	䌐
grqs	䖃
gru	㔷
gry	䐰
gryn	䁶
grys	䔰
gu	㙗
gur	䍓
gurt	䁑
gut	ㄢ
gyp	䉸
h1	㐒
h1n	䌃
h1s	㎕
h1st	㑑
h1t	㒖
h2	で
h2s	㞈
h3	䆅
h3pt	㒈
h3s	㡈
h3t	䎁
h@	㥡
hA	ㅑ
hAl	㕰
hAls	㜨
hAlt	㤗
hAm	㤹
hAms	䘁
hAn	㠤
hAnd	㠢
hAns	㒄
hAnt	㆑
hAp	〤
hAps	䍳
hApt	㘗
hAr	䈶
hArt	䈲
hAst	〉
hAt	㈄
hAts	䖐
hE	㊄
hEft	䀡
hEl	䁖
hElt	㈂
hEm	䕒
hEmt	䄁
hEn	㌠
hEnc	㥐
hEnd	㝱
hEngt	㙄
hEnkst	㙆
hEnkt	䀒
hEt	䕅
hEtst	䒙
hI	㦙
hIl	䂘
hIlf	㍙
hIlfst	䘙
hIlft	䖄
hIm	㘶
hIn	〨
hIr	䀱
hO	䌒
hOf	㖁
hOl	䍅
hOlT	䍈
hOpst	㥳
hOrst	㖃
hOx	䉉
hQr	䚀
hQrn	䀹
hU	㥄
hUPst	䈖
hUn	㠆
hUnt	㉅
hY	㥅
hYP	㥓
hYPt	䔹
hYlt	䈄
ha	す
han	㤷
har	䐕
has	〶
he	㞙
her	㍔
hern	て
hert	䔆
hir	ㆇ
ho	㉲
hof	䆗
hol	㐠
holst	㤃
holt	㑥
horn	䘖
hq	㝳
hqr	䍉
hqrn	䑲
hqrst	䅂
hqrt	〴
hu	䘑
hun	㉁
hup	㢑
hut	䄳
hy	㘅
i	㈅
im	㕵
in	㉷
ir	ㆂ
irt	㤠
j@	䌆
jA	〈
jATt	䂕
jAnc	䕰
jAng	䌥
jETt	ゔ
jEk	㔧
jEkt	㒔
jI	䕩
jN	䌸
jUm	䒑
jUn	㉥
ja	䄶
jar	ㄇ
je	㙦
jekt	㖖
jo	㝂
ju	䆆
k1	㙖
k1n	㎇
k3	䅦
k3f	䈳
k3fs	䑠
k3ft	㦈
k@	ぷ
k@s	䙲
kA	㌱
kAl	䂙
kAlt	㒁
kAm	䆉
kAmP	㥈
kAn	㆗
kAns	䎆
kAnst	ㄣ
kAr	㉓
kAs	ㄴ
kE	㎈
kET	㊔
kElp	䍂
kElt	㘰
kEmt	䉰
kEnst	㘲
kEnt	㒗
kEst	㡀
kI	㔂
kIT	䔤
kIc	㦑
kIn	㔶
kInt	㝨
kIr	㤙
kIs	䈒
kL	ㄥ
kLn	㕙
kLt	㘤
kN	ㅀ
kO	㐖
kOP	㐃
kOm	〇
kOmst	㑢
kOmt	ㄒ
kOn	㢇
kOrp	䈤
kQ	㕘
kQn	㜥
kQnt	䁅
kQr	㔩
kR	㐥
kRt	䐆
kU	䍸
kUnst	㡳
kUrT	䔲
kUt	䆁
kYs	㕶
ka	㜇
kam	㠶
ke	䊒
keks	㤢
ker	㝣
kern	䉕
ki	㥴
kirc	㠈
kl1	ㄘ
kl1n	䀆
kl1t	㝙
kl3	䒓
kl3n	㡱
kl3s	䉃
klA	㝓
klApt	㡣
klAr	㔤
klE	㔈
klEmt	䍱
klI	䕇
klIc	㎓
klOPt	䔢
klQ	㜵
kle	㖆
klept	䉹
klert	䐹
klq	㝗
kn@t	䔅
knA	㦔
knAks	䂒
knAlt	䕱
knEct	䌈
knI	㘣
knOP	䑴
knOx	䔃
knQ	䑑
knY	䅀
kna	㍳
knect	䕗
kni	䊕
ko	㌷
kon	䊐
kq	㝤
kr1	䙀
krA	䌑
krAn	䕲
krAnk	䖙
krAx	䂆
krAxst	㞇
krEm	䔉
krO	㌶
kra	㡗
kraxt	䔶
kri	㠉
kric	㐕
kricst	䉥
krict	㤳
krigt	䌩
krq	㢙
ku	㉆
kus	ぃ
kux	㞕
kvA	䘗
kvACt	䄧
kva	䁔
kvak	䙩
kver	䑰
kvikt	㜆
ky	㐴
l1	㑶
l1ct	㞉
l1mt	㉣
l1n	㤩
l2	䈀
l2fst	䘢
l2ft	㥤
l2t	㍠
l3	㘑
l3t	䌧
l@	ば
l@s	〧
lA	㝠
lAm	㙱
lAn	㔠
lAnc	䙙
lAng	䊀
lAngt	㙩
lAs	㑉
lAx	㞆
lAxst	䔐
lAxt	㝩
lE	ㅈ
lET	㘆
lEk	䉨
lEkt	䍇
lEnc	㑴
lEncs	䑱
lEncst	䙔
lEst	䂗
lEx	䁳
lI	㞓
lIc	㔁
lIct	ㅘ
lIst	䔓
lM	㕁
lN	び
lO	㐨
lOk	䙘
lOn	䑘
lQ	㡵
lR	㈈
lRn	䖘
lRt	䍹
lU	㡃
lUft	䉈
lUn	㠣
lUngs	㜡
la	䈈
lan	䔘
lant	䚃
lat	㝁
le	䀑
lec	㙹
lecs	䐇
lecst	䐙
lect	䂂
legt	䘩
lep	䘄
lernt	㜔
let	䑦
li	㈩
ligt	㝢
lin	㝉
linc	䖈
lip	㠅
lirt	䍕
lis	䐓
lit	㤔
lo	ㅒ
los	㐄
lot	䕳
lox	㡅
lq	㝸
lym	䅸
m1	こ
m1n	ㅢ
m1ns	䄃
m1nst	㥧
m1nt	䚅
m2	䈉
m2s	ぁ
m3s	さ
m@	ㆅ
m@s	㡸
mA	㑈
mAc	㤁
mAcst	䍒
mAks	䎀
mAl	〣
mAls	䊑
mAn	㈢
mAnc	䑩
mAnt	㠲
mAr	あ
mArk	䅳
mArkt	䉗
mAs	䒖
mAx	ゕ
mAxs	㐸
mAxst	ゑ
mAxt	ㅖ
mAxts	㑀
mE	㘢
mET	䌱
mElkt	䘨
mElt	䙢
mEn	㎔
mEnS	䆑
mEnt	㘐
mErkst	䊓
mErt	㊅
mEs	䈴
mI	㉦
mIS	㖈
mIc	め
mIlc	䅖
mIn	㒘
mIst	䑶
mIt	ぢ
mItm	䊉
mL	㉈
mLn	䉱
mLt	䙠
mN	ㅦ
mOl	䑉
mOnt	㥘
mOr	㠄
mQ	䉳
mQx	ㅰ
mQxt	㑒
mR	ㅐ
mU	ㄐ
mUmps	㙷
mUn	䊙
mUnt	】
mUs	㍶
mUst	㄰
mY	㚂
mYl	䙖
mYs	㕠
mYst	䈂
ma	㈤
mal	㡲
malst	㡕
malt	㙰
man	䕥
me	㌳
med	㉸
mer	㉙
mi	㕅
mil	䌅
mir	㌉
mis	㕔
mo	㘉
mon	㥱
mq	䚇
mu	㜕
mun	䉷
my	ㅠ
myl	䙗
myn	䅹
myr	䑂
mys	䈑
myt	㞒
n1	㑹
n1n	㆙
n2	㐁
n2n	㈵
n3	㐦
n@	ご
n@s	㑔
n@t	䎔
nA	㔀
nAk	㠂
nAn	㉡
nAs	㖘
nAx	㊇
nAxt	䙓
nAxts	㍹
nE	㑦
nEc	䑙
nEnt	㙥
nEst	㍆
nI	㜖
nIc	㜓
nIct	〳
nIcts	㉑
nIg	䉧
nIl	䀩
nIm	㢈
nImst	㉗
nInc	䌦
nIs	㕒
nIx	䅨
nM	ん
nN	ㆃ
nO	㌆
nOm	䑹
nOr	䁲
nOrd	㖀
nOx	ㄠ
nQs	㝃
nR	ㄡ
nRn	䑔
nRst	䎅
nRt	䌖
nUn	㒃
nUnc	㖂
na	ㅥ
nas	㦆
ne	ㆄ
nem	㆐
nh1m	䁥
nhAl	䙈
nhAst	䄉
nhof	㘩
nhun	㌔
nhy	ㄷ
ni	㝒
nirt	㥸
nis	䕵
no	㌒
nord	䁕
nq	䅙
nu	㕸
nuc	䉤
nul	㕨
nund	䀣
nur	ㅩ
nus	䌡
nygt	䒂
o	㈔
on	㜗
p@	㙲
pA	ㄹ
pAk	䉓
pAkst	䀙
pAkt	䌹
pAl	䘒
pAm	㞑
pAr	㡉
pArkt	䙃
pArt	䄓
pAs	㌵
pAst	㠓
pE	䍔
pEn	䐠
pIc	䀈
pIlT	䕦
pIm	㘸
pImp	䈁
pImpt	㠵
pL	㘷
pLn	㠷
pN	㔸
pO	㑃
pOst	㉒
pR	㔰
pRt	㝔
pU	㙵
pUT	㙶
pUTT	䁗
pUTt	〡
pUk	䑕
pUr	㥖
pUt	㍰
pYnkt	へ
pYp	䕃
pa	䄡
par	㥕
pe	䙐
per	㆓
perlx	䅰
pi	㠥
piT	䕖
pikst	㉖
pips	䑖
pir	㠱
pirt	䀁
pis	䅗
plA	䁣
plAC	䑤
plAT	㚐
plAt	㙣
plE	䌤
plQT	䉂
plUm	䀶
pla	㉰
plaT	䆕
plu	䀷
po	㈑
pr1s	䎘
prI	㤥
prIl	䘵
prO	㥥
prac	㒐
pri	㚓
pro	㕲
prqst	䀠
pru	䊄
pu	㞀
qf	㔡
r1	㠩
r1ct	䉢
r1f	㙉
r1g	㕑
r1n	ぇ
r1s	䐦
r2	䅱
r2m	㠹
r2mst	㠡
r2mt	㠦
r3	㖄
r3b	や
r3f	㚑
r3m	䐁
r3s	ふ
r@	㈆
r@s	㦖
rA	㔳
rAn	䅉
rAnt	䈷
rAps	䍲
rAt	㠁
rEct	㔕
rEk	䔡
rEkt	㈣
rEs	䉀
rI	㜢
rIT	䍗
rIc	ょ
rIn	䘣
rInc	㢅
rIs	㎉
rM	㍅
rN	㐐
rO	䄗
rOlt	㞗
rR	㍒
rU	䄹
rUC	䔒
rUCt	㡩
rUm	䁰
rUn	㉵
rUnc	㘂
rUnt	㥠
rY	䄱
rYk	䍥
rYkt	㠘
rYs	䀧
ra	䀰
rak	㒑
ral	㑧
ran	䙥
rat	䄢
rax	䔴
re	ㅳ
reg	䖑
ret	䐵
ri	㍣
ricst	䒃
rict	㡴
rinc	㙑
ring	㥇
rins	䐔
ro	㈨
ror	䌁
rot	㦉
ru	㔲
ruC	䍤
rufst	䕷
ruk	䕡
rum	㤵
rus	䚂
rut	㡨
ry	䔧
st1	䘘
st1n	䍰
st3	䘱
st@	㞃
st@s	䁐
st@t	䁸
stAc	㦓
stAgs	䕑
stAl	䎖
stE	䑸
stElt	䁉
stEn	㚖
stErn	㞅
stI	䄤
stIc	㡄
stIm	㔦
stImt	㘧
stM	㖐
stN	㑵
stNs	㥩
stR	㑲
stRn	䈐
stRt	䐡
stUnc	䙱
stY	䔖
stYk	䅡
stens	㜂
sti	㘱
stun	䔗
sty	䔙
t1	ㄙ
t1c	䘤
t2	㝄
t2s	䂃
t3	㔴
t3rt	䒔
t3xt	䅆
t@	ㄳ
t@s	䈡
t@st	ㅱ
t@t	䊂
tA	㙁
tAc	䌄
tAn	㤐
tAnTt	㝅
tAp	䕈
tAs	㞘
tAt	䀃
tE	㤸
tEm	䕕
tErt	㎅
tEst	㡤
tEt	㐶
tI	㑸
tIS	㡔
tIc	よ
tIm	䙉
tL	ㄔ
tLst	㑗
tLt	㎗
tN	㈷
tO	㙡
tOP	㤂
tOl	㖑
tOr	㌄
tR	ㄑ
tRm	㦘
tRn	㚈
tRs	㔢
tRt	㥲
tUnc	䆐
tUrm	㜱
tUrnt	䙄
tUx	㚒
tY	䌘
tYp	䌂
ta	㘈
tal	㙢
tam	䌕
tan	䂀
tax	㌕
te	ㄶ
ter	㝡
ti	㌧
tir	ゅ
tirt	㕤
to	㈹
ton	㐷
topt	䂓
tor	䔁
tos	㠑
tot	䁙
tq	㕄
tr3	䉲
tr3t	㤑
trA	䌵
trAm	㥉
trE	㢉
trIn	䁠
trInk	䌢
trInkt	䀲
trO	䈘
trOT	㚆
trUn	䑁
tre	㜴
tri	㈒
tro	䉅
tu	え
tun	㌖
tur	䘡
turnt	䉁
tus	䈣
tust	ㄦ
tut	ゆ
tux	㠴
ty	㜀
tyr	〆
u	㘥
um	㆖
un	㕆
ur	㎁
v1	㉤
v1l	ㄉ
v1ls	㙧
v1nt	㤘
v1p	㠔
v1s	㡂
v1st	㙔
v1t	䔇
v@	㦅
vA	ㄲ
vAl	㔗
vAlt	䍁
vAn	䐒
vAnt	㔑
vAr	㈁
vArm	䑷
vArn	䎉
vArs	䑇
vArst	㢕
vArt	㢔
vAs	ゐ
vAx	㍂
vAxt	䂅
vE	䈕
vEc	け
vEk	䄴
vEl	㒇
vElS	㥨
vElc	䘸
vEn	ㅤ
vEns	䈃
vEs	䐲
vI	㑁
vIS	䌳
vISt	㞖
vIc	䆒
vIl	㍧
vIlst	㐑
vIlt	䂑
vIn	㄀
vInkt	㑡
vIr	㎒
vIs	㎙
vIst	䌰
vN	㝹
vO	ㅅ
vOl	㖗
vOlf	䙴
vOlst	㥔
vOlt	䉄
vOr	㐣
vOrt	㒅
vOx	㦕
vQl	䚄
vQr	㌙
vUm	䆈
vUn	䙸
vUnt	䈨
vUrm	㙳
vUrst	䌔
va	㙠
van	㜒
vas	䔠
ve	ら
vecs	䕙
vem	䐑
ven	㘙
ver	㉄
verk	䑧
vert	㐆
verts	㕀
vi	〓
vir	ゖ
virf	㡙
virst	㞔
virt	ㄕ
vo	㈰
vol	䄔
von	䆄
vont	䔨
vos	㘒
vy	ㆉ
y	㐩
z1	㝆
z1m	䕠
z1n	㜦
z1t	㖉
z2	䂄
z3	㐹
z3gt	㦀
z3s	䙆
z3st	䐱
z@	だ
z@s	㚘
zA	㕂
zAT	䉑
zAft	䅲
zAgt	㌂
zAl	㔘
zAm	䊁
zAmt	㙐
zAn	䑃
zAnt	䊘
zAt	䊔
zAx	㔨
zE	㑘
zET	㤈
zETt	䒅
zEc	䀦
zEl	㝰
zElbst	䈙
zEn	㐅
zEnt	㔵
zEp	䕔
zEs	䆖
zI	㑄
zIT	㤉
zITt	㡒
zIc	㍁
zIct	㈗
zIn	㡹
zInc	䉘
zIncst	㤕
zIngt	㐧
zInt	㌥
zL	㜶
zLn	㢗
zLnt	䄵
zN	㄂
zNt	㕦
zO	ひ
zOl	ㄨ
zOls	䘓
zOlst	㆔
zOlt	㠰
zOn	㕉
zOnst	㚗
zQk	䄇
zR	㍉
zUn	䕄
zUnt	㥆
za	㍷
zac	ㅲ
zacst	㍀
zag	㠳
zagt	㖔
zak	䕢
zan	㝷
ze	㉐
zeks	䅶
zen	㔱
zer	ㅁ
zi	い
zib	䕓
zik	㤲
zis	㖙
zist	㔖
zit	㕗
zo	げ
zom	䙳
zos	䒀
zu	䉦
zux	㡢
zuxs	䀅
zuxst	䂇
zuxt	ㄱ
zy	䉙
zys	㘔